Charging Point Number,Transaction Start,Charge Start,Charge End,Transaction End,Start Wh,End Wh,Total Wh,Connect Time
6118,01/01/2020 02:04:13,01/01/2020 02:04:14,01/01/2020 09:42:50,01/01/2020 09:46:41,103497,126990,23493,462
6132,01/01/2020 13:40:41,01/01/2020 13:40:42,01/01/2020 14:24:48,01/01/2020 14:24:50,22619,25094,2475,44
6184,01/01/2020 16:37:09,01/01/2020 16:37:10,01/01/2020 16:50:23,01/01/2020 16:50:28,3373,4063,690,13
6132,01/01/2020 22:45:53,01/01/2020 22:45:54,02/01/2020 02:11:46,02/01/2020 02:11:59,25139,37557,12418,206
6132,02/01/2020 12:17:40,02/01/2020 12:17:41,02/01/2020 15:00:28,02/01/2020 15:00:28,37607,47385,9778,162
6184,02/01/2020 15:52:11,02/01/2020 15:52:12,02/01/2020 16:08:50,02/01/2020 16:08:53,4132,5026,894,16
6126,03/01/2020 10:31:43,03/01/2020 10:31:45,03/01/2020 10:48:38,03/01/2020 10:48:40,33772,34815,1043,16
6124,03/01/2020 15:54:45,03/01/2020 15:54:47,03/01/2020 18:29:45,03/01/2020 18:29:45,33645,42706,9061,155
6132,03/01/2020 12:22:14,03/01/2020 12:22:15,03/01/2020 16:48:42,03/01/2020 16:48:48,47551,63616,16065,266
6118,04/01/2020 00:11:40,04/01/2020 00:11:41,04/01/2020 10:42:50,04/01/2020 11:24:08,127431,151058,23627,672
6143,04/01/2020 10:34:11,04/01/2020 10:34:16,04/01/2020 11:00:58,04/01/2020 11:01:16,27654,29235,1581,27
6136,04/01/2020 11:08:15,04/01/2020 11:08:19,04/01/2020 11:51:55,04/01/2020 11:52:05,1910,4657,2747,43
6139,04/01/2020 11:42:44,04/01/2020 11:42:45,04/01/2020 12:01:13,04/01/2020 12:01:13,129948,131007,1059,18
6143,04/01/2020 11:55:14,04/01/2020 11:55:18,04/01/2020 18:31:19,04/01/2020 18:31:42,29239,53911,24672,396
6139,04/01/2020 12:01:35,04/01/2020 12:01:36,04/01/2020 14:06:15,04/01/2020 14:06:15,131008,137853,6845,124
6116,04/01/2020 18:36:15,04/01/2020 18:36:22,04/01/2020 20:49:04,04/01/2020 20:50:15,123284,130208,6924,134
6118,04/01/2020 23:54:21,04/01/2020 23:54:22,05/01/2020 10:12:49,05/01/2020 10:58:07,161082,185226,24144,663
6143,05/01/2020 16:53:59,05/01/2020 16:54:03,05/01/2020 18:16:23,05/01/2020 18:16:23,54021,59051,5030,82
6132,05/01/2020 15:09:51,05/01/2020 15:09:55,05/01/2020 18:02:57,05/01/2020 18:03:09,63854,74176,10322,173
6143,07/01/2020 19:22:32,07/01/2020 19:22:37,07/01/2020 22:23:07,07/01/2020 22:23:07,59292,70453,11161,180
6132,07/01/2020 17:35:43,07/01/2020 17:35:44,07/01/2020 21:41:03,07/01/2020 21:41:12,74489,89315,14826,245
6139,07/01/2020 21:54:40,07/01/2020 21:54:41,08/01/2020 06:03:49,08/01/2020 06:27:27,138248,165904,27656,512
6118,08/01/2020 22:02:13,08/01/2020 22:02:15,09/01/2020 08:42:53,09/01/2020 09:29:40,185851,210789,24938,687
6136,09/01/2020 09:12:59,09/01/2020 09:13:03,09/01/2020 09:25:24,09/01/2020 10:09:50,5243,6013,770,56
6116,09/01/2020 18:48:57,09/01/2020 18:49:03,09/01/2020 20:59:17,09/01/2020 20:59:54,132550,139323,6773,130
6136,09/01/2020 19:13:10,09/01/2020 19:13:14,09/01/2020 19:46:53,09/01/2020 22:08:55,6058,8149,2091,175
6132,09/01/2020 15:57:43,09/01/2020 15:57:44,09/01/2020 21:32:36,09/01/2020 21:32:41,89529,109630,20101,334
6132,10/01/2020 16:01:43,10/01/2020 16:01:44,10/01/2020 19:50:44,10/01/2020 19:50:49,109721,123425,13704,229
6139,10/01/2020 22:28:10,10/01/2020 22:28:11,11/01/2020 05:51:13,11/01/2020 08:06:12,166221,190800,24579,578
6136,11/01/2020 08:31:35,11/01/2020 08:31:39,11/01/2020 09:11:24,11/01/2020 11:02:49,8321,10844,2523,151
6132,11/01/2020 15:43:35,11/01/2020 15:43:39,11/01/2020 17:15:44,11/01/2020 17:15:53,123523,129037,5514,92
6132,11/01/2020 17:15:56,11/01/2020 17:15:56,11/01/2020 18:23:01,11/01/2020 18:23:15,129037,133097,4060,67
6143,12/01/2020 16:14:07,12/01/2020 16:14:11,12/01/2020 20:50:45,12/01/2020 20:50:45,71013,88110,17097,276
6132,12/01/2020 16:55:09,12/01/2020 16:55:13,12/01/2020 17:08:09,12/01/2020 17:08:13,133216,133966,750,13
6132,12/01/2020 17:08:16,12/01/2020 17:08:20,12/01/2020 17:23:18,12/01/2020 17:23:23,133966,134863,897,15
6132,13/01/2020 15:55:03,13/01/2020 15:55:04,13/01/2020 20:32:02,13/01/2020 20:32:11,134974,151698,16724,277
6146,13/01/2020 22:19:20,13/01/2020 22:19:25,14/01/2020 07:27:58,14/01/2020 07:28:17,3065,25014,21949,548
6143,14/01/2020 19:52:59,14/01/2020 19:53:03,14/01/2020 22:06:29,14/01/2020 22:06:29,88342,96443,8101,133
6132,14/01/2020 17:10:37,14/01/2020 17:10:38,14/01/2020 20:36:58,14/01/2020 20:37:02,151805,164194,12389,206
6106,16/01/2020 09:09:37,16/01/2020 09:09:39,16/01/2020 10:45:47,16/01/2020 10:45:47,865,4465,3600,96
6101,16/01/2020 14:58:57,16/01/2020 14:58:59,16/01/2020 22:02:29,16/01/2020 22:02:29,3344,28531,25187,423
6103,16/01/2020 14:06:42,16/01/2020 14:06:43,16/01/2020 15:58:57,16/01/2020 16:27:38,3387,10587,7200,140
6118,18/01/2020 00:59:15,18/01/2020 00:59:16,18/01/2020 10:12:51,18/01/2020 10:46:38,212016,237530,25514,587
6143,18/01/2020 15:14:49,18/01/2020 15:14:52,18/01/2020 19:00:59,18/01/2020 19:00:59,96882,110967,14085,226
6146,18/01/2020 12:26:31,18/01/2020 12:26:34,18/01/2020 15:01:02,18/01/2020 16:13:02,25553,32930,7377,226
6103,18/01/2020 16:32:53,18/01/2020 16:32:54,18/01/2020 17:37:05,18/01/2020 17:37:14,10829,14902,4073,64
6120,18/01/2020 18:15:27,18/01/2020 18:15:28,18/01/2020 18:38:58,18/01/2020 18:39:00,32507,33849,1342,23
6124,19/01/2020 15:18:04,19/01/2020 15:18:06,19/01/2020 20:43:15,20/01/2020 08:37:25,44636,63600,18964,1039
6103,20/01/2020 13:49:16,20/01/2020 13:49:17,20/01/2020 16:01:31,20/01/2020 16:01:38,15125,23553,8428,132
6118,20/01/2020 20:55:52,20/01/2020 20:55:57,20/01/2020 21:59:18,20/01/2020 21:59:39,237832,241748,3916,63
6103,22/01/2020 17:40:27,22/01/2020 17:40:28,22/01/2020 19:51:52,22/01/2020 19:52:20,23803,32206,8403,131
6143,23/01/2020 19:43:02,23/01/2020 19:43:09,23/01/2020 22:17:23,23/01/2020 22:17:23,111563,120947,9384,154
6143,26/01/2020 17:12:19,26/01/2020 17:12:24,26/01/2020 21:23:47,26/01/2020 21:23:47,121277,136719,15442,251
6103,27/01/2020 13:03:58,27/01/2020 13:03:59,27/01/2020 14:39:43,27/01/2020 14:40:12,38343,44463,6120,96
6119,27/01/2020 13:19:11,27/01/2020 13:19:16,27/01/2020 19:30:44,27/01/2020 19:39:15,41974,61122,19148,380
6143,30/01/2020 20:00:55,30/01/2020 20:01:00,30/01/2020 22:30:28,30/01/2020 22:30:28,137184,146436,9252,149
6136,31/01/2020 08:58:16,31/01/2020 08:58:21,31/01/2020 09:18:06,31/01/2020 09:27:01,13605,14807,1202,28
6143,31/01/2020 20:23:21,31/01/2020 20:23:26,31/01/2020 23:13:36,31/01/2020 23:13:36,146544,157095,10551,170
6118,01/02/2020 03:17:46,01/02/2020 03:17:47,01/02/2020 12:12:52,01/02/2020 12:32:00,243580,267952,24372,554
6148,01/02/2020 16:37:46,01/02/2020 16:37:56,01/02/2020 19:32:20,01/02/2020 19:32:27,36929,46575,9646,174
6130,02/02/2020 12:03:01,02/02/2020 12:03:05,02/02/2020 13:08:46,02/02/2020 13:08:46,6291,10475,4184,65
6143,02/02/2020 13:19:00,02/02/2020 13:19:05,02/02/2020 15:16:00,02/02/2020 15:16:00,157283,164606,7323,117
6167,02/02/2020 13:09:01,02/02/2020 13:09:03,02/02/2020 15:47:35,02/02/2020 15:53:18,0,0,0,164
6118,02/02/2020 20:30:27,02/02/2020 20:30:31,02/02/2020 21:58:00,02/02/2020 21:58:22,268159,273477,5318,87
6167,03/02/2020 20:15:47,03/02/2020 20:15:48,03/02/2020 22:44:47,03/02/2020 22:44:49,0,0,0,149
6193,04/02/2020 09:36:11,04/02/2020 09:36:16,04/02/2020 11:36:55,04/02/2020 11:38:09,886,886,0,121
6107,04/02/2020 10:44:14,04/02/2020 10:44:16,04/02/2020 15:48:45,04/02/2020 15:48:47,5752,23925,18173,304
6118,05/02/2020 01:08:35,05/02/2020 01:08:37,05/02/2020 11:12:50,05/02/2020 11:19:51,273800,298053,24253,611
6146,06/02/2020 14:58:29,06/02/2020 14:58:32,06/02/2020 17:58:12,06/02/2020 17:58:14,35205,43365,8160,179
6143,06/02/2020 20:34:59,06/02/2020 20:35:03,06/02/2020 22:34:25,06/02/2020 22:34:25,165105,172536,7431,119
6107,07/02/2020 14:16:27,07/02/2020 14:16:29,07/02/2020 18:25:26,07/02/2020 18:25:29,24285,38422,14137,249
6124,07/02/2020 19:34:17,07/02/2020 19:34:19,07/02/2020 21:40:46,07/02/2020 21:40:46,65851,73270,7419,126
6143,08/02/2020 12:27:40,08/02/2020 12:27:45,08/02/2020 13:26:52,08/02/2020 13:26:52,172723,176397,3674,59
6143,08/02/2020 14:47:16,08/02/2020 14:47:20,08/02/2020 16:40:41,08/02/2020 16:40:41,176404,183294,6890,113
6143,08/02/2020 18:48:11,08/02/2020 18:48:15,08/02/2020 22:03:37,08/02/2020 22:03:37,183305,195525,12220,195
6124,08/02/2020 18:48:52,08/02/2020 18:48:54,08/02/2020 21:37:58,08/02/2020 21:37:58,73379,83241,9862,169
6143,09/02/2020 13:52:15,09/02/2020 13:52:19,09/02/2020 18:20:30,09/02/2020 18:20:30,195604,211564,15960,268
6159,09/02/2020 15:10:30,09/02/2020 15:10:37,10/02/2020 00:24:40,10/02/2020 05:16:59,2941,2941,0,846
6130,11/02/2020 21:59:51,11/02/2020 21:59:52,11/02/2020 23:00:04,11/02/2020 23:00:22,11612,15454,3842,60
6167,11/02/2020 20:57:40,11/02/2020 20:57:41,11/02/2020 23:34:49,11/02/2020 23:34:52,0,0,0,157
6136,12/02/2020 13:01:20,12/02/2020 13:01:21,12/02/2020 13:49:34,12/02/2020 13:49:44,16265,19214,2949,48
6167,12/02/2020 20:56:55,12/02/2020 20:56:56,12/02/2020 23:33:05,12/02/2020 23:45:36,0,0,0,168
6167,13/02/2020 20:43:09,13/02/2020 20:43:10,13/02/2020 23:15:32,13/02/2020 23:24:32,0,0,0,161
6118,14/02/2020 02:07:30,14/02/2020 02:07:31,14/02/2020 14:13:06,14/02/2020 14:14:25,299174,323075,23901,726
6110,14/02/2020 22:33:49,14/02/2020 22:33:50,15/02/2020 08:16:48,15/02/2020 09:26:09,8923,42232,33309,652
6112,15/02/2020 14:27:30,15/02/2020 14:27:31,15/02/2020 16:48:39,15/02/2020 16:48:41,78064,85963,7899,141
6132,15/02/2020 22:38:25,15/02/2020 22:38:27,15/02/2020 22:54:36,16/02/2020 09:13:19,168188,169217,1029,634
6167,15/02/2020 20:53:14,15/02/2020 20:53:15,15/02/2020 23:28:06,15/02/2020 23:33:31,0,0,0,160
6118,16/02/2020 02:24:42,16/02/2020 02:24:43,16/02/2020 13:42:45,16/02/2020 13:46:30,323509,347566,24057,681
6104,16/02/2020 10:05:54,16/02/2020 10:05:57,16/02/2020 11:07:36,16/02/2020 11:07:38,38304,41854,3550,61
6136,16/02/2020 11:46:17,16/02/2020 11:46:20,16/02/2020 15:12:36,16/02/2020 15:12:36,19684,32131,12447,206
6159,16/02/2020 10:01:51,16/02/2020 10:01:58,16/02/2020 13:35:56,16/02/2020 13:36:01,2941,2941,0,214
6119,17/02/2020 10:07:41,17/02/2020 10:08:18,17/02/2020 11:00:21,18/02/2020 09:34:37,64123,67353,3230,1406
6167,18/02/2020 18:27:53,18/02/2020 18:27:54,19/02/2020 00:15:02,19/02/2020 00:15:18,0,0,0,347
6119,19/02/2020 19:46:56,19/02/2020 19:47:04,19/02/2020 22:47:53,19/02/2020 22:48:04,67564,78638,11074,181
6167,20/02/2020 08:18:45,20/02/2020 08:18:51,20/02/2020 09:52:30,20/02/2020 09:54:06,0,0,0,95
6132,20/02/2020 20:10:48,20/02/2020 20:10:49,20/02/2020 22:18:21,21/02/2020 07:09:14,169777,174597,4820,658
6118,20/02/2020 17:02:15,20/02/2020 17:02:20,20/02/2020 21:03:41,20/02/2020 21:05:16,348298,362356,14058,243
6132,21/02/2020 21:41:48,21/02/2020 21:41:49,22/02/2020 06:52:28,22/02/2020 09:30:18,174669,204895,30226,708
6118,22/02/2020 10:39:15,22/02/2020 10:39:16,22/02/2020 12:02:40,22/02/2020 12:02:43,362660,367594,4934,83
6118,22/02/2020 23:58:14,22/02/2020 23:58:16,23/02/2020 09:42:52,23/02/2020 09:56:21,367840,391862,24022,598
6118,23/02/2020 12:46:16,23/02/2020 12:46:20,23/02/2020 14:35:28,23/02/2020 14:35:44,391879,398578,6699,109
6132,23/02/2020 17:05:50,23/02/2020 17:05:52,23/02/2020 20:10:07,24/02/2020 08:02:39,205053,213436,8383,896
6132,24/02/2020 21:48:35,24/02/2020 21:48:36,25/02/2020 04:33:28,25/02/2020 07:02:23,213508,235138,21630,553
6119,24/02/2020 18:56:11,24/02/2020 18:56:18,25/02/2020 03:27:01,25/02/2020 08:45:57,79305,110905,31600,829
6118,25/02/2020 11:56:07,25/02/2020 11:56:10,25/02/2020 14:19:58,25/02/2020 14:19:58,398972,406213,7241,143
6132,25/02/2020 19:24:40,25/02/2020 19:24:42,26/02/2020 00:09:49,26/02/2020 07:10:43,235205,249582,14377,706
6119,25/02/2020 21:10:46,25/02/2020 21:10:50,26/02/2020 00:49:48,26/02/2020 07:09:43,111000,119306,8306,598
6132,26/02/2020 21:16:30,26/02/2020 21:16:31,27/02/2020 05:20:38,27/02/2020 07:15:04,249656,276037,26381,598
6132,28/02/2020 23:38:11,28/02/2020 23:38:21,29/02/2020 03:29:55,29/02/2020 09:06:01,276255,287244,10989,567
6175,29/02/2020 14:19:55,29/02/2020 14:20:02,29/02/2020 14:25:14,29/02/2020 14:25:14,234748920,234763484,14564,5
6127,29/02/2020 16:14:10,29/02/2020 16:14:11,29/02/2020 16:24:37,29/02/2020 16:24:39,15872,15880,8,10
6136,29/02/2020 20:24:46,29/02/2020 20:24:47,01/03/2020 11:20:10,01/03/2020 11:20:10,33721,37431,3710,895
6132,29/02/2020 21:32:54,29/02/2020 21:32:55,29/02/2020 23:57:26,29/02/2020 23:57:33,287318,296086,8768,144
6130,01/03/2020 12:00:02,01/03/2020 12:00:13,01/03/2020 13:29:32,01/03/2020 13:29:32,17701,23354,5653,89
6136,01/03/2020 12:24:26,01/03/2020 12:24:27,01/03/2020 22:00:15,01/03/2020 22:00:15,37437,40337,2900,575
6132,01/03/2020 18:39:45,01/03/2020 18:40:07,01/03/2020 23:25:07,02/03/2020 06:11:38,296219,309753,13534,691
6132,02/03/2020 21:59:15,02/03/2020 21:59:27,03/03/2020 01:33:00,03/03/2020 07:45:34,309842,319675,9833,586
6136,03/03/2020 19:52:36,03/03/2020 19:52:50,03/03/2020 22:11:43,03/03/2020 22:11:43,40567,48893,8326,139
6132,03/03/2020 21:02:38,03/03/2020 21:02:45,04/03/2020 02:06:24,04/03/2020 07:07:33,319755,335138,15383,604
6147,03/03/2020 21:13:19,03/03/2020 21:13:22,03/03/2020 23:11:32,03/03/2020 23:12:52,29535,36684,7149,119
6132,05/03/2020 18:28:08,05/03/2020 18:28:28,06/03/2020 01:33:55,06/03/2020 07:16:23,335340,357296,21956,768
6147,05/03/2020 21:25:58,05/03/2020 21:26:02,05/03/2020 23:31:01,05/03/2020 23:31:08,36918,44508,7590,125
6132,06/03/2020 21:52:35,06/03/2020 21:52:44,07/03/2020 06:20:50,07/03/2020 08:58:33,357379,384539,27160,665
6118,06/03/2020 19:55:44,06/03/2020 19:55:48,06/03/2020 23:10:47,06/03/2020 23:11:02,408052,420065,12013,195
6124,07/03/2020 14:19:41,07/03/2020 14:19:45,07/03/2020 15:31:07,07/03/2020 15:31:07,86613,90780,4167,71
6136,07/03/2020 19:11:54,07/03/2020 19:11:58,07/03/2020 22:23:54,07/03/2020 22:23:54,49360,61384,12024,192
6118,08/03/2020 11:29:50,08/03/2020 11:29:54,08/03/2020 14:18:26,08/03/2020 14:18:30,420249,430631,10382,168
6132,08/03/2020 14:45:27,08/03/2020 14:45:42,08/03/2020 20:35:17,09/03/2020 08:01:34,384713,402223,17510,1036
6119,08/03/2020 22:19:59,08/03/2020 22:20:06,09/03/2020 07:11:58,09/03/2020 08:50:12,120854,153992,33138,630
6142,09/03/2020 18:22:53,09/03/2020 18:22:54,09/03/2020 22:36:30,09/03/2020 22:36:34,37242,52412,15170,253
6133,11/03/2020 20:09:50,11/03/2020 20:09:56,12/03/2020 06:35:23,12/03/2020 06:35:23,31149,51831,20682,625
6132,11/03/2020 21:31:23,11/03/2020 21:31:24,12/03/2020 01:20:32,12/03/2020 07:13:24,402582,413734,11152,582
6171,11/03/2020 16:13:05,11/03/2020 16:13:07,11/03/2020 21:36:23,11/03/2020 21:40:16,283387706,283399815,12109,327
6174,12/03/2020 13:36:17,12/03/2020 13:36:18,12/03/2020 13:47:07,12/03/2020 13:48:19,272976375,272976376,1,12
6136,12/03/2020 18:42:37,12/03/2020 18:42:45,12/03/2020 21:43:19,12/03/2020 21:43:22,61967,73078,11111,180
6132,12/03/2020 19:54:48,12/03/2020 19:54:59,13/03/2020 01:23:28,13/03/2020 07:09:39,413813,430407,16594,674
6183,13/03/2020 09:01:04,13/03/2020 09:01:07,13/03/2020 11:37:48,13/03/2020 13:25:51,304509713,304516997,7284,264
6132,13/03/2020 21:23:51,13/03/2020 21:24:05,14/03/2020 05:25:39,14/03/2020 09:44:25,430488,456249,25761,740
6156,14/03/2020 06:48:52,14/03/2020 06:48:53,14/03/2020 07:15:43,14/03/2020 07:15:45,2580,4106,1526,26
6142,14/03/2020 10:04:54,14/03/2020 10:04:56,14/03/2020 15:58:08,14/03/2020 15:58:13,52956,74101,21145,353
6169,14/03/2020 10:13:45,14/03/2020 10:13:46,14/03/2020 11:42:15,14/03/2020 11:52:05,273041233,273043186,1953,98
6136,14/03/2020 11:52:32,14/03/2020 11:52:44,14/03/2020 18:43:10,14/03/2020 18:43:14,73269,98767,25498,410
6142,14/03/2020 16:02:45,14/03/2020 16:02:47,14/03/2020 19:37:57,14/03/2020 22:01:06,74102,83776,9674,358
6138,14/03/2020 13:29:59,14/03/2020 13:30:02,14/03/2020 17:10:29,14/03/2020 17:21:13,0,0,0,231
6125,15/03/2020 09:53:08,15/03/2020 09:53:12,15/03/2020 11:20:24,15/03/2020 11:20:43,38976,44427,5451,87
6169,15/03/2020 11:47:04,15/03/2020 11:47:51,15/03/2020 17:09:36,15/03/2020 17:09:38,273043246,273058440,15194,322
6155,15/03/2020 11:01:42,15/03/2020 11:01:43,15/03/2020 17:43:16,15/03/2020 17:43:18,271561265,271568259,6994,401
6142,15/03/2020 17:52:57,15/03/2020 17:52:59,16/03/2020 01:26:02,16/03/2020 07:08:52,83876,107937,24061,795
6136,15/03/2020 18:50:14,15/03/2020 18:50:15,16/03/2020 08:23:19,16/03/2020 08:23:21,98887,102183,3296,813
6125,15/03/2020 18:52:35,15/03/2020 18:52:39,16/03/2020 03:00:42,16/03/2020 08:12:30,44584,75105,30521,799
6103,16/03/2020 10:18:45,16/03/2020 10:18:46,16/03/2020 13:53:18,16/03/2020 14:43:47,50366,61932,11566,265
6103,17/03/2020 10:04:42,17/03/2020 10:04:43,17/03/2020 13:21:14,17/03/2020 13:21:16,62030,72829,10799,196
6155,17/03/2020 18:00:40,17/03/2020 18:00:41,17/03/2020 22:18:06,17/03/2020 22:18:08,271568406,271573133,4727,257
6101,17/03/2020 20:55:50,17/03/2020 20:55:53,17/03/2020 23:30:20,18/03/2020 00:04:35,35785,43032,7247,188
6124,18/03/2020 14:15:32,18/03/2020 14:15:46,18/03/2020 16:18:14,18/03/2020 16:18:14,92116,98217,6101,122
6155,18/03/2020 17:35:59,18/03/2020 17:36:00,18/03/2020 21:58:34,18/03/2020 21:58:36,271573192,271577648,4456,262
6169,19/03/2020 14:41:57,19/03/2020 14:41:59,19/03/2020 16:11:38,19/03/2020 16:48:13,273058690,273061168,2478,126
6132,19/03/2020 19:08:10,19/03/2020 19:08:21,20/03/2020 01:09:25,20/03/2020 07:23:31,456959,475230,18271,735
6187,21/03/2020 13:34:11,21/03/2020 13:34:14,21/03/2020 16:30:30,21/03/2020 16:30:46,2995,12689,9694,176
6187,21/03/2020 16:35:48,21/03/2020 16:35:49,21/03/2020 16:41:19,21/03/2020 16:41:22,12715,12947,232,5
6175,22/03/2020 11:29:39,22/03/2020 11:29:44,22/03/2020 11:29:45,22/03/2020 11:58:54,274471057,274471058,1,29
6132,22/03/2020 11:35:59,22/03/2020 11:36:05,22/03/2020 13:37:59,22/03/2020 20:07:39,475511,479075,3564,511
6169,22/03/2020 13:22:40,22/03/2020 13:22:41,22/03/2020 15:15:37,22/03/2020 15:17:33,273061362,273064826,3464,114
6124,23/03/2020 16:20:00,23/03/2020 16:20:39,23/03/2020 19:21:00,23/03/2020 19:21:00,98827,109312,10485,181
6193,25/03/2020 13:41:23,25/03/2020 13:41:24,25/03/2020 16:02:55,25/03/2020 16:02:58,1694,10309,8615,141
6101,26/03/2020 20:32:12,26/03/2020 20:32:15,26/03/2020 23:00:08,26/03/2020 23:00:11,44090,51558,7468,147
6118,27/03/2020 18:50:20,27/03/2020 18:50:24,27/03/2020 23:00:25,27/03/2020 23:00:42,432960,447195,14235,250
6155,28/03/2020 14:35:53,28/03/2020 14:36:20,28/03/2020 19:58:39,28/03/2020 19:58:41,271578353,271584053,5700,322
6132,31/03/2020 18:20:34,31/03/2020 18:20:39,31/03/2020 20:55:27,01/04/2020 07:04:27,480359,485956,5597,763
6118,31/03/2020 13:28:29,31/03/2020 13:28:33,31/03/2020 18:53:19,31/03/2020 19:07:10,447712,465140,17428,338
6118,01/04/2020 10:22:18,01/04/2020 10:22:25,01/04/2020 12:23:25,01/04/2020 12:23:39,465217,471911,6694,121
6101,01/04/2020 10:18:45,01/04/2020 10:18:48,01/04/2020 12:50:30,01/04/2020 12:50:32,52211,59663,7452,151
6132,02/04/2020 16:44:45,02/04/2020 16:44:46,02/04/2020 22:48:40,03/04/2020 07:08:49,486130,504995,18865,864
6184,03/04/2020 11:26:11,03/04/2020 11:26:17,03/04/2020 11:33:35,03/04/2020 16:18:11,5915,6015,100,292
6118,03/04/2020 11:40:25,03/04/2020 11:40:33,03/04/2020 13:47:26,03/04/2020 16:28:03,472193,477096,4903,287
6142,04/04/2020 14:47:26,04/04/2020 14:47:28,04/04/2020 18:37:33,04/04/2020 18:37:37,115375,129176,13801,230
6101,06/04/2020 15:01:57,06/04/2020 15:02:01,06/04/2020 17:05:50,06/04/2020 17:37:16,67753,73971,6218,155
6120,06/04/2020 15:22:23,06/04/2020 15:22:24,06/04/2020 18:51:34,06/04/2020 18:51:36,49071,61063,11992,209
6142,07/04/2020 18:11:49,07/04/2020 18:11:50,08/04/2020 07:10:02,08/04/2020 08:33:57,129550,150548,20998,862
6118,07/04/2020 18:31:47,07/04/2020 18:31:51,07/04/2020 22:24:07,07/04/2020 22:24:15,477635,491980,14345,232
6169,08/04/2020 19:17:26,08/04/2020 19:18:50,08/04/2020 20:31:27,08/04/2020 20:31:29,273065709,273069751,4042,74
6101,11/04/2020 09:38:10,11/04/2020 09:38:13,11/04/2020 12:26:24,11/04/2020 12:26:26,74527,82067,7540,168
6169,12/04/2020 08:27:09,12/04/2020 08:27:18,12/04/2020 10:00:24,12/04/2020 11:07:10,273069960,273072484,2524,160
6147,14/04/2020 13:18:01,14/04/2020 13:18:06,14/04/2020 15:18:01,14/04/2020 15:18:06,49300,56583,7283,120
6142,14/04/2020 17:20:11,14/04/2020 17:20:12,14/04/2020 23:51:11,15/04/2020 06:04:17,151328,172189,20861,764
6156,15/04/2020 15:47:44,15/04/2020 15:47:48,15/04/2020 18:31:46,15/04/2020 18:32:38,5489,15036,9547,164
6132,16/04/2020 17:43:37,16/04/2020 17:43:38,17/04/2020 02:17:17,17/04/2020 09:13:16,511979,540115,28136,929
6142,16/04/2020 20:55:52,16/04/2020 20:55:54,17/04/2020 07:10:04,17/04/2020 08:22:06,172385,198750,26365,686
6127,18/04/2020 11:52:31,18/04/2020 11:52:32,19/04/2020 12:32:20,19/04/2020 12:32:22,25545,31005,5460,1479
6120,19/04/2020 09:25:46,19/04/2020 09:25:47,19/04/2020 13:32:33,19/04/2020 13:41:54,62651,75913,13262,256
6147,19/04/2020 13:20:21,19/04/2020 13:20:25,19/04/2020 18:22:30,19/04/2020 18:22:35,57178,73720,16542,302
6138,19/04/2020 17:39:06,19/04/2020 17:39:09,19/04/2020 19:41:27,19/04/2020 19:41:29,0,0,0,122
6169,24/04/2020 17:06:36,24/04/2020 17:06:38,24/04/2020 18:40:55,24/04/2020 20:47:58,273072984,273076201,3217,221
6143,25/04/2020 09:53:45,25/04/2020 09:53:50,25/04/2020 17:25:20,25/04/2020 17:25:20,220424,248180,27756,451
6132,25/04/2020 13:42:47,25/04/2020 13:42:49,25/04/2020 20:30:29,26/04/2020 09:49:07,541090,562869,21779,1206
6147,25/04/2020 19:17:21,25/04/2020 19:17:25,25/04/2020 20:02:10,25/04/2020 20:02:16,74428,77085,2657,44
6169,02/05/2020 07:27:48,02/05/2020 07:27:50,02/05/2020 08:55:34,02/05/2020 08:55:34,273076593,273080597,4004,87
6169,02/05/2020 10:46:36,02/05/2020 10:46:38,02/05/2020 12:06:38,02/05/2020 13:35:29,273080603,273082234,1631,168
6153,07/05/2020 12:28:36,07/05/2020 12:28:37,07/05/2020 22:52:15,08/05/2020 10:56:57,282445493,282482946,37453,1348
6171,08/05/2020 08:09:16,08/05/2020 08:09:22,08/05/2020 13:56:53,08/05/2020 13:57:12,283403356,283423186,19830,347
6169,09/05/2020 07:23:29,09/05/2020 07:23:31,09/05/2020 08:28:33,09/05/2020 08:28:35,273082600,273085649,3049,65
6169,09/05/2020 10:42:14,09/05/2020 10:42:16,09/05/2020 11:45:02,09/05/2020 17:51:52,273085657,273086952,1295,429
6147,09/05/2020 17:43:06,09/05/2020 17:43:11,09/05/2020 22:51:59,10/05/2020 00:14:51,78766,96207,17441,391
6132,10/05/2020 12:21:51,10/05/2020 12:21:54,10/05/2020 17:49:09,11/05/2020 09:17:45,579547,596318,16771,1255
6155,10/05/2020 12:20:40,10/05/2020 12:20:41,10/05/2020 17:05:53,10/05/2020 17:05:55,271586699,271591833,5134,285
6125,11/05/2020 09:15:19,11/05/2020 09:15:21,11/05/2020 12:39:53,11/05/2020 12:39:55,85323,95222,9899,204
6132,13/05/2020 05:30:31,13/05/2020 05:30:35,13/05/2020 07:56:21,13/05/2020 07:56:27,596488,605279,8791,145
6120,15/05/2020 14:53:01,15/05/2020 14:53:02,15/05/2020 20:38:27,15/05/2020 20:38:29,78527,98340,19813,345
6136,16/05/2020 12:04:59,16/05/2020 12:05:04,16/05/2020 16:28:09,16/05/2020 16:51:31,108679,124670,15991,286
6132,16/05/2020 17:00:19,16/05/2020 17:00:23,16/05/2020 19:20:27,16/05/2020 19:21:12,605702,614164,8462,140
6127,16/05/2020 20:41:59,16/05/2020 20:42:00,16/05/2020 22:48:12,16/05/2020 22:48:12,38071,39018,947,126
6136,16/05/2020 23:07:13,16/05/2020 23:07:14,17/05/2020 11:27:56,17/05/2020 11:27:58,124702,127263,2561,740
6169,22/05/2020 07:05:29,22/05/2020 07:05:31,22/05/2020 09:19:38,22/05/2020 15:57:38,273087407,273092924,5517,532
6120,22/05/2020 10:27:02,22/05/2020 10:27:04,22/05/2020 15:44:47,22/05/2020 15:44:49,99268,117759,18491,317
6167,22/05/2020 14:21:02,22/05/2020 14:21:03,22/05/2020 22:08:49,22/05/2020 22:08:55,0,0,0,467
6136,23/05/2020 11:52:21,23/05/2020 11:52:27,23/05/2020 17:38:50,23/05/2020 17:38:50,127917,149754,21837,346
6156,24/05/2020 03:21:32,24/05/2020 03:21:34,24/05/2020 11:39:57,24/05/2020 11:39:59,16465,43702,27237,498
6171,25/05/2020 14:00:30,25/05/2020 14:00:36,25/05/2020 20:22:59,25/05/2020 20:23:15,283424132,283444578,20446,382
6125,27/05/2020 12:18:06,27/05/2020 12:18:08,27/05/2020 14:43:01,27/05/2020 15:34:06,98994,105253,6259,196
6119,27/05/2020 15:59:19,27/05/2020 15:59:22,27/05/2020 18:00:04,27/05/2020 18:00:06,170261,176820,6559,120
6183,28/05/2020 11:13:33,28/05/2020 11:13:36,28/05/2020 13:30:33,28/05/2020 13:30:35,304520362,304527790,7428,137
6169,29/05/2020 09:38:52,29/05/2020 09:38:55,29/05/2020 10:36:09,29/05/2020 13:38:45,273093238,273094391,1153,239
6155,29/05/2020 10:48:06,29/05/2020 10:48:07,29/05/2020 13:51:40,29/05/2020 13:51:42,271592871,271596101,3230,183
6118,29/05/2020 19:01:38,29/05/2020 19:01:42,29/05/2020 22:10:55,29/05/2020 22:11:01,498538,510192,11654,189
6183,30/05/2020 09:07:17,30/05/2020 09:07:20,30/05/2020 12:16:37,30/05/2020 12:16:39,304527883,304535737,7854,189
6100,30/05/2020 12:34:26,30/05/2020 12:34:31,30/05/2020 17:20:42,30/05/2020 17:20:42,186107,203812,17705,286
6136,31/05/2020 11:00:14,31/05/2020 11:00:16,31/05/2020 19:29:45,31/05/2020 19:29:47,150281,151198,917,509
6119,31/05/2020 08:51:08,31/05/2020 08:51:11,31/05/2020 11:07:21,31/05/2020 11:11:38,177819,185126,7307,140
6118,01/06/2020 18:32:37,01/06/2020 18:32:42,01/06/2020 22:42:15,01/06/2020 22:50:33,510596,524500,13904,257
6143,06/06/2020 17:16:51,06/06/2020 17:16:55,06/06/2020 20:30:08,06/06/2020 20:30:08,252638,264327,11689,193
6143,07/06/2020 09:20:28,07/06/2020 09:20:30,07/06/2020 09:30:19,07/06/2020 09:30:21,264391,264874,483,9
6143,07/06/2020 12:06:50,07/06/2020 12:06:56,07/06/2020 19:30:33,07/06/2020 20:06:27,268701,295908,27207,479
6118,07/06/2020 11:07:26,07/06/2020 11:07:30,07/06/2020 14:01:04,07/06/2020 14:01:10,525164,535775,10611,173
6171,07/06/2020 16:07:27,07/06/2020 16:07:34,07/06/2020 16:13:29,07/06/2020 16:13:59,283445443,283445761,318,6
6136,08/06/2020 18:08:34,08/06/2020 18:08:35,08/06/2020 21:07:04,08/06/2020 21:07:06,152079,162295,10216,178
6143,09/06/2020 14:00:05,09/06/2020 14:00:07,09/06/2020 14:40:09,09/06/2020 14:40:11,296073,298360,2287,40
6152,10/06/2020 07:49:08,10/06/2020 07:49:12,10/06/2020 07:51:28,10/06/2020 07:51:42,272822716,272822810,94,2
6183,10/06/2020 17:24:40,10/06/2020 17:24:43,10/06/2020 17:41:53,10/06/2020 17:41:55,304536193,304536860,667,17
6170,11/06/2020 12:54:53,11/06/2020 12:54:54,11/06/2020 20:22:25,11/06/2020 21:14:06,6441,31640,25199,499
6120,12/06/2020 12:31:21,12/06/2020 12:31:27,12/06/2020 14:30:55,12/06/2020 14:31:00,120290,127529,7239,119
6142,14/06/2020 11:43:11,14/06/2020 11:43:13,14/06/2020 18:30:51,14/06/2020 18:31:12,203188,227910,24722,408
6132,14/06/2020 16:42:02,14/06/2020 16:42:04,14/06/2020 20:47:34,15/06/2020 06:32:43,617597,630035,12438,830
6144,16/06/2020 19:02:07,16/06/2020 19:02:12,17/06/2020 00:21:31,17/06/2020 07:01:05,10382,28320,17938,718
6121,16/06/2020 18:11:58,16/06/2020 18:12:01,16/06/2020 20:19:41,16/06/2020 20:21:17,32936,40962,8026,129
6118,17/06/2020 19:10:42,17/06/2020 19:10:49,18/06/2020 00:05:32,18/06/2020 06:10:22,536854,553474,16620,659
6143,18/06/2020 16:42:35,18/06/2020 16:42:40,18/06/2020 20:13:00,18/06/2020 20:13:00,310913,323870,12957,210
6136,20/06/2020 08:32:54,20/06/2020 08:32:56,20/06/2020 12:18:21,20/06/2020 12:18:23,167362,180313,12951,225
6136,20/06/2020 12:49:07,20/06/2020 12:49:08,20/06/2020 13:40:46,20/06/2020 13:41:15,180316,183443,3127,52
6133,20/06/2020 15:27:24,20/06/2020 15:27:29,20/06/2020 20:24:13,20/06/2020 20:34:45,63470,79702,16232,307
6118,20/06/2020 19:57:03,20/06/2020 19:57:07,20/06/2020 23:30:25,21/06/2020 07:52:41,553743,565421,11678,715
6143,21/06/2020 17:54:49,21/06/2020 17:54:53,21/06/2020 19:00:14,21/06/2020 19:00:57,346382,350036,3654,66
6125,22/06/2020 13:32:46,22/06/2020 13:32:48,22/06/2020 14:50:14,22/06/2020 14:50:16,108885,113484,4599,77
6133,22/06/2020 19:27:04,22/06/2020 19:27:09,22/06/2020 23:28:45,22/06/2020 23:28:49,79880,94382,14502,241
6136,23/06/2020 06:50:45,23/06/2020 06:50:46,23/06/2020 18:43:36,23/06/2020 18:43:36,198962,202294,3332,712
6136,23/06/2020 18:48:03,23/06/2020 18:48:04,24/06/2020 07:35:35,24/06/2020 07:35:37,202295,204348,2053,767
6136,24/06/2020 07:37:19,24/06/2020 07:37:20,24/06/2020 20:15:20,24/06/2020 20:15:20,204348,204796,448,758
6142,24/06/2020 07:51:32,24/06/2020 07:51:34,24/06/2020 15:06:17,24/06/2020 15:06:17,234727,258712,23985,434
6171,24/06/2020 07:12:54,24/06/2020 07:13:00,24/06/2020 10:24:57,24/06/2020 10:25:05,283462571,283473740,11169,192
6120,24/06/2020 14:11:35,24/06/2020 14:11:35,24/06/2020 14:11:35,24/06/2020 14:13:29,130710,130711,1,1
6120,24/06/2020 14:13:54,24/06/2020 14:13:54,24/06/2020 14:13:54,24/06/2020 14:16:46,130711,130711,0,2
6133,24/06/2020 18:52:49,24/06/2020 18:52:53,24/06/2020 19:53:53,24/06/2020 19:53:59,94604,98213,3609,61
6120,24/06/2020 18:17:42,24/06/2020 18:17:48,24/06/2020 19:36:19,24/06/2020 19:39:32,130734,135594,4860,81
6120,24/06/2020 19:39:51,24/06/2020 19:40:01,24/06/2020 21:16:57,24/06/2020 21:17:07,135594,141549,5955,97
6118,24/06/2020 19:34:47,24/06/2020 19:34:51,25/06/2020 00:27:08,25/06/2020 05:30:09,565837,582631,16794,595
6118,26/06/2020 09:14:03,26/06/2020 09:14:10,26/06/2020 17:37:42,26/06/2020 17:38:00,582793,601081,18288,503
6142,26/06/2020 21:36:23,26/06/2020 21:36:25,27/06/2020 05:50:33,27/06/2020 07:16:28,258728,286105,27377,580
6169,27/06/2020 14:21:56,27/06/2020 14:21:58,27/06/2020 15:56:02,27/06/2020 17:27:08,273095757,273099082,3325,185
6118,27/06/2020 13:48:00,27/06/2020 13:48:01,27/06/2020 15:18:26,27/06/2020 15:26:33,602239,607340,5101,98
6143,27/06/2020 20:47:43,27/06/2020 20:47:44,28/06/2020 07:38:27,28/06/2020 07:38:30,350749,372167,21418,650
6143,28/06/2020 08:13:53,28/06/2020 08:13:57,28/06/2020 12:54:02,28/06/2020 12:54:18,372170,389496,17326,280
6177,28/06/2020 12:59:50,28/06/2020 12:59:54,28/06/2020 16:21:28,28/06/2020 16:21:32,172,6141,5969,201
6155,29/06/2020 14:36:57,29/06/2020 14:36:58,29/06/2020 16:51:45,29/06/2020 16:51:47,271597895,271599676,1781,134
6118,29/06/2020 15:42:11,29/06/2020 15:42:12,29/06/2020 18:03:39,29/06/2020 18:03:41,607581,614659,7078,141
6118,30/06/2020 15:15:46,30/06/2020 15:15:47,30/06/2020 16:53:13,30/06/2020 16:53:15,614784,620365,5581,97
6100,30/06/2020 14:32:30,30/06/2020 14:32:33,30/06/2020 17:25:25,30/06/2020 17:25:27,210055,218807,8752,172
6183,30/06/2020 22:51:42,30/06/2020 22:51:45,01/07/2020 07:07:30,01/07/2020 07:27:39,304537743,304546962,9219,515
6136,01/07/2020 08:53:32,01/07/2020 08:53:33,01/07/2020 15:57:06,01/07/2020 15:57:08,205189,228368,23179,423
6118,01/07/2020 15:23:07,01/07/2020 15:23:08,01/07/2020 17:37:14,01/07/2020 17:37:16,620374,626044,5670,134
6190,02/07/2020 07:54:13,02/07/2020 07:54:13,02/07/2020 07:54:57,02/07/2020 07:55:03,654,6966,6312,0
6154,02/07/2020 08:05:33,02/07/2020 08:05:33,02/07/2020 08:06:03,02/07/2020 08:06:05,5638,5672,34,0
6118,02/07/2020 18:39:23,02/07/2020 18:39:27,02/07/2020 21:37:56,02/07/2020 21:38:10,626192,637216,11024,178
6193,03/07/2020 12:08:14,03/07/2020 12:08:19,03/07/2020 13:26:50,03/07/2020 13:27:07,13819,18387,4568,78
6132,03/07/2020 18:56:58,03/07/2020 18:57:00,03/07/2020 23:37:25,04/07/2020 00:09:39,640198,654680,14482,312
6118,04/07/2020 13:16:29,04/07/2020 13:16:30,04/07/2020 16:07:17,04/07/2020 16:07:19,637377,645030,7653,170
6144,05/07/2020 08:42:09,05/07/2020 08:42:14,05/07/2020 13:21:56,05/07/2020 13:22:00,28939,45690,16751,279
6143,05/07/2020 15:33:58,05/07/2020 15:34:03,05/07/2020 19:38:31,05/07/2020 19:38:31,396216,411383,15167,244
6171,06/07/2020 16:47:21,06/07/2020 16:47:23,06/07/2020 18:55:29,06/07/2020 18:55:29,283474220,283481014,6794,128
6163,06/07/2020 14:30:25,06/07/2020 14:30:29,06/07/2020 17:21:39,06/07/2020 17:21:41,290528826,290538873,10047,171
6118,06/07/2020 15:07:20,06/07/2020 15:07:22,06/07/2020 17:54:37,06/07/2020 17:54:38,645200,652583,7383,167
6144,08/07/2020 12:26:34,08/07/2020 12:26:40,08/07/2020 12:26:51,08/07/2020 12:27:18,47505,47510,5,0
6193,09/07/2020 08:49:58,09/07/2020 08:50:02,09/07/2020 10:15:36,09/07/2020 10:15:48,18406,23337,4931,85
6136,09/07/2020 14:25:05,09/07/2020 14:25:06,09/07/2020 16:45:43,09/07/2020 16:45:45,228890,230942,2052,140
6111,09/07/2020 17:58:35,09/07/2020 17:58:37,09/07/2020 20:01:31,09/07/2020 20:01:33,49314,56477,7163,122
6132,10/07/2020 21:05:32,10/07/2020 21:05:33,10/07/2020 21:06:32,10/07/2020 21:06:37,655278,655334,56,1
6132,10/07/2020 21:07:01,10/07/2020 21:07:03,11/07/2020 06:46:44,11/07/2020 09:16:42,655334,688730,33396,729
6136,11/07/2020 09:03:08,11/07/2020 09:03:09,11/07/2020 11:31:48,11/07/2020 11:31:50,231143,235095,3952,148
6106,11/07/2020 15:09:54,11/07/2020 15:09:56,11/07/2020 16:19:51,11/07/2020 16:19:53,11807,15803,3996,69
6171,11/07/2020 11:40:35,11/07/2020 11:40:36,11/07/2020 16:34:47,11/07/2020 16:35:25,283493793,283501460,7667,294
6136,11/07/2020 16:40:32,11/07/2020 16:40:35,11/07/2020 19:29:51,11/07/2020 19:29:51,237201,247613,10412,169
6106,11/07/2020 21:25:30,11/07/2020 21:25:32,11/07/2020 22:37:42,11/07/2020 22:37:42,16903,21027,4124,72
6143,12/07/2020 09:09:17,12/07/2020 09:09:22,12/07/2020 13:57:08,12/07/2020 14:22:43,412125,429575,17450,313
6136,12/07/2020 12:19:52,12/07/2020 12:19:53,12/07/2020 16:39:35,12/07/2020 16:39:35,247588,248445,857,259
6132,13/07/2020 18:15:23,13/07/2020 18:15:25,13/07/2020 21:53:03,14/07/2020 08:10:14,713100,723443,10343,834
6193,14/07/2020 08:53:49,14/07/2020 08:53:53,14/07/2020 10:56:26,14/07/2020 11:11:38,23457,30152,6695,137
6172,15/07/2020 11:10:56,15/07/2020 11:10:59,15/07/2020 11:43:31,15/07/2020 11:43:38,304553403,304555270,1867,32
6146,15/07/2020 15:50:36,15/07/2020 15:50:37,15/07/2020 20:38:45,15/07/2020 20:38:58,60907,78543,17636,288
6193,16/07/2020 08:13:37,16/07/2020 08:13:41,16/07/2020 10:03:12,16/07/2020 10:29:43,30242,36165,5923,136
6132,16/07/2020 21:30:26,16/07/2020 21:30:28,17/07/2020 00:24:42,17/07/2020 06:59:09,723746,731645,7899,568
6193,17/07/2020 14:25:30,17/07/2020 14:25:35,17/07/2020 16:14:24,17/07/2020 16:27:26,36221,42165,5944,121
6143,18/07/2020 07:15:29,18/07/2020 07:15:31,18/07/2020 08:13:20,18/07/2020 08:13:22,430119,433522,3403,57
6123,18/07/2020 11:08:55,18/07/2020 11:08:56,18/07/2020 11:11:46,18/07/2020 11:11:48,50346,50506,160,2
6143,18/07/2020 12:28:51,18/07/2020 12:28:55,18/07/2020 17:38:59,18/07/2020 17:38:59,433543,453077,19534,310
6193,18/07/2020 11:46:21,18/07/2020 11:46:25,18/07/2020 13:42:35,18/07/2020 13:42:42,42204,49016,6812,116
6136,18/07/2020 08:17:05,18/07/2020 08:17:07,18/07/2020 14:19:25,18/07/2020 14:19:27,248971,270031,21060,362
6113,18/07/2020 14:58:47,18/07/2020 16:01:41,18/07/2020 16:51:15,18/07/2020 16:51:17,110597231,110600044,2813,112
6132,18/07/2020 21:46:46,18/07/2020 21:46:48,19/07/2020 01:49:46,19/07/2020 11:03:26,756496,768755,12259,796
6171,19/07/2020 16:19:30,19/07/2020 16:19:32,19/07/2020 18:47:59,19/07/2020 18:47:59,283501827,283509474,7647,148
6120,19/07/2020 16:16:15,19/07/2020 16:16:16,19/07/2020 16:23:25,19/07/2020 16:23:27,144099,144502,403,7
6155,19/07/2020 15:27:10,19/07/2020 15:27:13,19/07/2020 16:50:07,19/07/2020 16:50:09,271601061,271602618,1557,82
6143,19/07/2020 19:53:02,19/07/2020 19:53:03,19/07/2020 21:23:46,19/07/2020 21:23:48,465518,470692,5174,90
6136,20/07/2020 06:59:17,20/07/2020 06:59:19,20/07/2020 08:42:50,20/07/2020 08:45:31,281552,287782,6230,106
6136,22/07/2020 16:08:06,22/07/2020 16:08:12,22/07/2020 20:23:15,22/07/2020 20:23:28,314232,329967,15735,255
6136,23/07/2020 07:32:46,23/07/2020 07:32:47,23/07/2020 14:19:18,23/07/2020 14:19:18,330022,330992,970,406
6143,23/07/2020 10:32:54,23/07/2020 10:32:55,23/07/2020 12:04:57,23/07/2020 12:05:07,471109,476643,5534,92
6144,23/07/2020 14:34:42,23/07/2020 14:34:44,23/07/2020 16:17:12,23/07/2020 16:17:21,69101,75339,6238,102
6136,24/07/2020 09:58:27,24/07/2020 09:58:29,24/07/2020 13:30:17,24/07/2020 13:30:19,331090,343712,12622,211
6111,25/07/2020 10:51:15,25/07/2020 10:51:18,25/07/2020 13:07:09,25/07/2020 13:07:12,58159,64727,6568,135
6119,25/07/2020 09:14:06,25/07/2020 09:14:10,25/07/2020 13:41:23,25/07/2020 13:42:00,212041,226757,14716,267
6171,25/07/2020 13:49:53,25/07/2020 13:49:55,25/07/2020 16:20:52,25/07/2020 16:20:54,283509813,283517175,7362,151
6171,26/07/2020 17:05:36,26/07/2020 17:05:38,26/07/2020 19:29:49,26/07/2020 19:50:12,283517236,283524812,7576,164
6175,27/07/2020 16:13:11,27/07/2020 16:13:13,27/07/2020 18:13:34,27/07/2020 18:13:44,274475798,274482939,7141,120
6132,27/07/2020 19:52:14,27/07/2020 19:52:16,28/07/2020 00:30:10,28/07/2020 08:06:21,778797,792995,14198,734
6159,27/07/2020 19:01:12,27/07/2020 19:01:17,27/07/2020 21:10:16,27/07/2020 21:11:18,8883,16202,7319,130
6118,27/07/2020 16:30:14,27/07/2020 16:30:41,27/07/2020 16:59:02,27/07/2020 21:38:02,664345,666059,1714,307
6168,28/07/2020 10:56:06,28/07/2020 10:56:08,28/07/2020 17:04:27,28/07/2020 17:04:35,272970340,272992451,22111,368
6109,28/07/2020 11:45:29,28/07/2020 11:45:33,28/07/2020 13:22:30,28/07/2020 13:22:32,49976,56142,6166,97
6142,28/07/2020 17:20:06,28/07/2020 17:20:08,28/07/2020 17:20:41,28/07/2020 17:20:41,364586,364618,32,0
6142,28/07/2020 17:21:11,28/07/2020 17:21:12,28/07/2020 17:23:59,28/07/2020 17:24:01,364618,364745,127,2
6132,28/07/2020 19:40:20,28/07/2020 19:40:22,29/07/2020 01:47:50,29/07/2020 07:20:45,793052,813227,20175,700
6168,29/07/2020 19:07:53,29/07/2020 19:07:55,29/07/2020 22:58:39,29/07/2020 23:01:24,272993421,273004388,10967,233
6142,30/07/2020 12:36:28,30/07/2020 12:36:29,30/07/2020 12:42:31,30/07/2020 12:42:38,364972,365309,337,6
6142,30/07/2020 12:42:55,30/07/2020 12:42:56,30/07/2020 13:04:38,30/07/2020 13:04:40,365309,366532,1223,21
6144,30/07/2020 19:00:57,30/07/2020 19:29:09,30/07/2020 19:43:16,30/07/2020 19:43:16,76736,77516,780,42
6143,31/07/2020 10:57:52,31/07/2020 10:57:56,31/07/2020 16:55:50,31/07/2020 16:57:15,477572,499681,22109,359
6146,31/07/2020 16:36:26,31/07/2020 16:36:29,31/07/2020 16:36:42,31/07/2020 16:36:44,85192,85193,1,0
6136,31/07/2020 14:29:18,31/07/2020 14:29:19,31/07/2020 17:08:12,31/07/2020 17:08:14,344428,353110,8682,158
6168,01/08/2020 10:45:41,01/08/2020 10:45:43,01/08/2020 14:43:27,01/08/2020 14:43:27,273004522,273017632,13110,237
6188,01/08/2020 12:54:09,01/08/2020 12:54:10,01/08/2020 16:32:25,01/08/2020 16:32:53,274117091,274123560,6469,218
6153,01/08/2020 20:52:03,01/08/2020 20:52:22,02/08/2020 06:02:25,02/08/2020 12:15:20,282525716,282558855,33139,923
6132,02/08/2020 18:37:34,02/08/2020 18:37:36,02/08/2020 21:44:11,03/08/2020 08:01:18,839489,848291,8802,803
6118,02/08/2020 18:57:06,02/08/2020 18:57:08,02/08/2020 20:27:13,02/08/2020 20:27:15,667356,672492,5136,90
6168,03/08/2020 16:24:52,03/08/2020 16:24:54,03/08/2020 20:12:40,03/08/2020 20:13:47,273017739,273028665,10926,228
6143,03/08/2020 17:11:47,03/08/2020 17:11:48,04/08/2020 07:07:18,04/08/2020 07:07:18,500028,504826,4798,835
6171,03/08/2020 17:44:07,03/08/2020 17:44:09,03/08/2020 20:09:30,03/08/2020 20:16:53,283525338,283532987,7649,152
6133,04/08/2020 08:27:43,04/08/2020 08:27:45,04/08/2020 08:47:48,04/08/2020 08:47:53,102491,103670,1179,20
6163,04/08/2020 09:05:22,04/08/2020 09:05:26,04/08/2020 10:46:08,04/08/2020 10:46:21,290541906,290547942,6036,100
6125,04/08/2020 10:45:49,04/08/2020 10:45:51,04/08/2020 11:33:38,04/08/2020 11:33:47,118385,121347,2962,47
6171,04/08/2020 14:05:12,04/08/2020 14:05:13,04/08/2020 14:20:46,04/08/2020 14:20:48,283537222,283538085,863,15
6193,05/08/2020 09:06:05,05/08/2020 09:06:09,05/08/2020 11:02:52,05/08/2020 11:02:55,49868,56626,6758,116
6171,05/08/2020 19:58:51,05/08/2020 19:58:55,05/08/2020 22:25:10,05/08/2020 22:25:12,283545548,283553754,8206,146
6177,05/08/2020 20:21:38,05/08/2020 20:21:41,05/08/2020 20:31:46,05/08/2020 20:32:20,7631,8028,397,10
6118,05/08/2020 18:02:28,05/08/2020 18:02:32,06/08/2020 00:29:03,06/08/2020 06:37:41,672868,677139,4271,755
6177,05/08/2020 20:32:38,05/08/2020 20:32:41,06/08/2020 07:59:31,06/08/2020 07:59:36,8028,32669,24641,686
6171,07/08/2020 08:41:51,07/08/2020 08:42:12,07/08/2020 11:24:20,07/08/2020 11:24:22,283553817,283562818,9001,162
6168,07/08/2020 15:40:21,07/08/2020 15:40:23,07/08/2020 19:37:58,07/08/2020 19:49:16,273040518,273052271,11753,248
6169,07/08/2020 18:32:22,07/08/2020 18:32:24,07/08/2020 20:14:21,07/08/2020 20:39:27,273100512,273104791,4279,127
6132,07/08/2020 20:43:36,07/08/2020 20:43:37,07/08/2020 20:44:17,07/08/2020 20:44:24,848772,848814,42,0
6171,08/08/2020 12:12:53,08/08/2020 12:12:53,08/08/2020 12:12:53,08/08/2020 12:13:14,283562897,283562897,0,0
6171,08/08/2020 12:13:39,08/08/2020 12:13:40,08/08/2020 15:02:10,08/08/2020 15:02:24,283562897,283571427,8530,168
6171,08/08/2020 17:15:44,08/08/2020 17:15:46,08/08/2020 19:44:14,08/08/2020 19:44:14,283571434,283579214,7780,148
6193,08/08/2020 19:43:13,08/08/2020 19:43:16,08/08/2020 21:48:28,08/08/2020 22:04:08,56770,63799,7029,140
6171,09/08/2020 19:20:15,09/08/2020 19:20:16,09/08/2020 20:05:29,09/08/2020 20:05:31,283579272,283581782,2510,45
6171,09/08/2020 20:06:21,09/08/2020 20:06:22,09/08/2020 23:15:12,09/08/2020 23:15:12,283581783,283592176,10393,188
6163,10/08/2020 13:36:59,10/08/2020 13:37:03,10/08/2020 18:17:29,10/08/2020 18:17:41,290548256,290565457,17201,280
6126,10/08/2020 17:38:02,10/08/2020 17:38:06,10/08/2020 21:59:29,10/08/2020 22:08:26,63509,72428,8919,270
6168,13/08/2020 16:20:20,13/08/2020 16:20:22,13/08/2020 19:42:55,13/08/2020 19:54:08,273064500,273074146,9646,213
6132,13/08/2020 17:25:55,13/08/2020 17:26:02,13/08/2020 21:55:05,13/08/2020 21:55:05,881150,897201,16051,269
6139,13/08/2020 18:53:01,13/08/2020 18:53:04,13/08/2020 19:34:58,13/08/2020 19:35:00,215070,217567,2497,41
6143,14/08/2020 13:43:39,14/08/2020 13:43:59,14/08/2020 15:38:14,14/08/2020 15:38:16,511051,516870,5819,114
6132,14/08/2020 22:52:51,14/08/2020 22:53:02,15/08/2020 04:53:58,15/08/2020 04:53:58,897324,919698,22374,361
6108,14/08/2020 19:05:22,14/08/2020 19:05:25,15/08/2020 02:35:16,15/08/2020 02:35:21,58915,83499,24584,449
6144,14/08/2020 19:06:35,14/08/2020 19:06:36,15/08/2020 01:08:28,15/08/2020 07:03:34,78323,96212,17889,716
6118,15/08/2020 08:27:30,15/08/2020 08:27:30,15/08/2020 08:27:30,15/08/2020 08:27:44,705016,705016,0,0
6118,15/08/2020 08:28:05,15/08/2020 08:28:05,15/08/2020 08:28:05,15/08/2020 08:28:59,705016,705017,1,0
6143,15/08/2020 09:31:24,15/08/2020 09:31:26,15/08/2020 12:43:40,15/08/2020 12:43:54,518644,530051,11407,192
6132,15/08/2020 22:59:02,15/08/2020 22:59:04,16/08/2020 04:23:30,16/08/2020 09:28:28,919786,937330,17544,629
6133,16/08/2020 16:05:46,16/08/2020 16:05:51,16/08/2020 20:48:54,16/08/2020 20:49:11,105078,122099,17021,283
6148,18/08/2020 09:46:44,18/08/2020 09:46:46,18/08/2020 13:25:04,18/08/2020 13:25:20,69591,83214,13623,218
6118,19/08/2020 10:06:54,19/08/2020 10:06:56,19/08/2020 10:06:57,19/08/2020 10:53:41,716999,717004,5,46
6118,19/08/2020 13:02:29,19/08/2020 13:02:31,19/08/2020 15:38:33,19/08/2020 15:38:35,717016,723491,6475,156
6168,19/08/2020 14:35:58,19/08/2020 14:36:00,19/08/2020 20:24:14,19/08/2020 20:24:14,273076489,273097040,20551,348
6193,20/08/2020 10:33:56,20/08/2020 10:34:01,20/08/2020 11:44:57,20/08/2020 11:49:55,73380,77007,3627,75
6143,20/08/2020 17:16:10,20/08/2020 17:16:11,21/08/2020 11:12:19,21/08/2020 11:12:21,530652,533765,3113,1076
6142,20/08/2020 19:33:20,20/08/2020 19:33:22,20/08/2020 23:57:15,21/08/2020 07:27:49,406049,419649,13600,714
6132,21/08/2020 07:13:01,21/08/2020 07:13:03,21/08/2020 07:13:20,21/08/2020 07:13:27,942574,942589,15,0
6171,21/08/2020 17:42:34,21/08/2020 17:42:36,21/08/2020 20:20:31,21/08/2020 20:20:33,283592931,283599849,6918,157
6110,21/08/2020 20:40:30,21/08/2020 20:40:32,21/08/2020 22:33:47,22/08/2020 09:09:29,61680,66046,4366,748
6193,21/08/2020 19:07:37,21/08/2020 19:07:39,21/08/2020 21:25:29,21/08/2020 21:26:03,77070,85118,8048,138
6132,22/08/2020 21:33:15,22/08/2020 21:33:17,22/08/2020 23:39:50,23/08/2020 09:30:46,942775,947885,5110,717
6136,23/08/2020 11:10:20,23/08/2020 11:10:23,23/08/2020 16:15:46,23/08/2020 16:15:46,398571,417379,18808,305
6193,23/08/2020 11:55:15,23/08/2020 11:55:20,23/08/2020 13:36:08,23/08/2020 13:36:12,85195,90732,5537,100
6118,23/08/2020 10:27:24,23/08/2020 10:27:29,23/08/2020 13:20:45,23/08/2020 15:00:10,724011,732778,8767,272
6197,24/08/2020 17:14:30,24/08/2020 17:14:30,24/08/2020 17:14:30,24/08/2020 17:18:10,1,1,0,3
6169,24/08/2020 17:54:03,24/08/2020 17:54:42,24/08/2020 17:54:43,24/08/2020 18:28:57,273105656,273105658,2,34
6168,25/08/2020 22:30:52,25/08/2020 22:30:54,26/08/2020 03:20:05,26/08/2020 08:31:00,273111930,273126231,14301,600
6183,26/08/2020 10:35:21,26/08/2020 10:35:23,26/08/2020 11:03:00,26/08/2020 11:03:02,304549174,304550725,1551,27
6193,26/08/2020 09:48:36,26/08/2020 09:48:40,26/08/2020 11:57:45,26/08/2020 12:03:17,90867,97828,6961,134
6126,28/08/2020 09:42:13,28/08/2020 09:42:18,28/08/2020 13:59:40,28/08/2020 13:59:52,74542,77348,2806,257
6100,28/08/2020 15:44:39,28/08/2020 15:44:45,28/08/2020 18:29:21,28/08/2020 18:39:29,225284,227829,2545,174
6155,28/08/2020 17:06:12,28/08/2020 17:06:13,28/08/2020 20:21:49,28/08/2020 20:21:52,271605465,271608342,2877,195
6132,29/08/2020 08:07:58,29/08/2020 08:08:02,29/08/2020 09:31:09,29/08/2020 09:31:52,948575,953721,5146,83
6144,29/08/2020 10:17:47,29/08/2020 10:17:52,29/08/2020 15:59:29,29/08/2020 19:15:49,97117,115892,18775,538
6100,29/08/2020 12:19:21,29/08/2020 12:19:25,29/08/2020 21:49:06,29/08/2020 21:49:35,227918,244041,16123,570
6144,29/08/2020 19:52:52,29/08/2020 19:53:00,29/08/2020 22:25:44,29/08/2020 22:25:46,115896,125109,9213,152
6143,30/08/2020 10:57:16,30/08/2020 10:57:19,30/08/2020 12:07:45,30/08/2020 12:07:45,534800,539027,4227,70
6118,30/08/2020 19:51:13,30/08/2020 19:51:17,31/08/2020 00:38:10,31/08/2020 09:29:40,749133,764976,15843,818
6143,31/08/2020 13:07:43,31/08/2020 13:07:48,31/08/2020 14:13:19,31/08/2020 14:13:19,539148,543133,3985,65
6120,31/08/2020 12:11:18,31/08/2020 12:11:22,31/08/2020 13:08:19,31/08/2020 13:09:24,155143,158493,3350,58
6119,31/08/2020 12:56:24,31/08/2020 12:56:25,31/08/2020 21:59:37,31/08/2020 22:00:57,240566,269629,29063,544
6168,01/09/2020 08:55:19,01/09/2020 08:55:21,01/09/2020 16:04:48,01/09/2020 17:16:42,273126529,273149299,22770,501
6193,01/09/2020 08:58:28,01/09/2020 08:58:34,01/09/2020 11:00:05,01/09/2020 11:00:18,98110,105091,6981,121
6153,31/08/2020 14:30:31,31/08/2020 14:30:32,31/08/2020 22:09:01,01/09/2020 12:00:56,282560226,282588081,27855,1290
6118,02/09/2020 19:10:57,02/09/2020 19:10:58,02/09/2020 21:12:16,02/09/2020 21:12:18,765302,772200,6898,121
6193,03/09/2020 10:04:07,03/09/2020 10:04:13,03/09/2020 12:14:46,03/09/2020 12:14:50,105186,112321,7135,130
6119,03/09/2020 15:13:04,03/09/2020 15:13:05,03/09/2020 17:02:37,03/09/2020 17:03:39,270182,276064,5882,110
6120,03/09/2020 21:44:01,03/09/2020 21:44:06,04/09/2020 06:12:48,04/09/2020 06:12:52,158905,178019,19114,508
6133,03/09/2020 06:50:44,03/09/2020 06:50:45,03/09/2020 23:00:12,04/09/2020 06:54:52,133595,190597,57002,1444
6132,04/09/2020 10:46:57,04/09/2020 10:46:58,04/09/2020 11:55:53,04/09/2020 11:55:55,955765,959611,3846,68
6168,04/09/2020 19:30:46,04/09/2020 19:30:48,05/09/2020 03:05:21,05/09/2020 09:36:35,273149454,273173923,24469,845
6120,04/09/2020 19:11:05,04/09/2020 19:11:09,05/09/2020 04:57:36,05/09/2020 04:57:39,178085,185193,7108,586
6136,04/09/2020 18:35:34,04/09/2020 18:35:35,05/09/2020 07:07:13,05/09/2020 07:07:15,418644,452943,34299,751
6118,04/09/2020 21:29:50,04/09/2020 21:29:51,05/09/2020 06:41:53,05/09/2020 07:09:54,772446,796185,23739,580
6143,05/09/2020 09:02:54,05/09/2020 09:02:55,05/09/2020 18:05:33,05/09/2020 18:05:35,543691,544703,1012,542
6132,04/09/2020 23:57:24,04/09/2020 23:57:25,05/09/2020 04:38:16,05/09/2020 11:00:44,959670,974391,14721,663
6115,05/09/2020 09:32:29,05/09/2020 09:32:30,05/09/2020 12:29:02,05/09/2020 13:57:11,95218,105743,10525,264
6136,05/09/2020 10:12:26,05/09/2020 10:12:28,05/09/2020 13:59:55,05/09/2020 14:19:52,452959,461984,9025,247
6112,05/09/2020 15:06:11,05/09/2020 15:06:15,05/09/2020 15:29:16,05/09/2020 15:31:18,124016,125400,1384,25
6106,05/09/2020 18:48:00,05/09/2020 18:48:06,05/09/2020 18:57:38,05/09/2020 18:57:57,38632,39197,565,9
6120,05/09/2020 19:13:56,05/09/2020 19:14:01,06/09/2020 00:43:16,06/09/2020 08:14:32,185266,203466,18200,780
6136,06/09/2020 09:53:31,06/09/2020 09:53:31,06/09/2020 09:53:31,06/09/2020 09:53:56,462082,462082,0,0
6136,06/09/2020 09:54:56,06/09/2020 09:55:00,06/09/2020 11:44:33,06/09/2020 11:44:33,462082,468947,6865,109
6132,05/09/2020 21:45:14,05/09/2020 21:45:15,06/09/2020 01:56:24,06/09/2020 10:05:22,974444,987255,12811,740
6116,06/09/2020 12:41:22,06/09/2020 12:41:32,06/09/2020 14:19:44,06/09/2020 14:20:14,229586,235838,6252,98
6101,06/09/2020 14:02:02,06/09/2020 14:02:03,06/09/2020 17:41:47,06/09/2020 17:56:52,104506,115295,10789,234
6119,06/09/2020 05:57:37,06/09/2020 05:57:38,06/09/2020 19:41:33,06/09/2020 19:41:35,276748,321264,44516,823
6118,06/09/2020 19:32:15,06/09/2020 19:32:19,06/09/2020 20:33:26,06/09/2020 20:33:38,796385,800155,3770,61
6101,07/09/2020 16:57:34,07/09/2020 16:57:35,07/09/2020 19:25:01,07/09/2020 19:25:09,115409,124061,8652,147
6132,07/09/2020 21:48:23,07/09/2020 21:48:24,07/09/2020 22:02:07,07/09/2020 22:02:11,987429,987977,548,13
6132,07/09/2020 22:08:38,07/09/2020 22:08:39,08/09/2020 07:03:15,08/09/2020 07:03:24,987978,1019651,31673,534
6132,08/09/2020 18:12:56,08/09/2020 18:12:57,08/09/2020 20:32:33,08/09/2020 20:38:32,1019705,1027471,7766,145
6118,08/09/2020 19:23:43,08/09/2020 19:23:47,08/09/2020 23:16:24,09/09/2020 06:13:04,800423,813334,12911,649
6118,09/09/2020 12:16:15,09/09/2020 12:16:30,09/09/2020 12:59:05,09/09/2020 16:22:55,813370,815923,2553,246
6120,09/09/2020 18:24:10,09/09/2020 18:24:16,09/09/2020 23:49:20,10/09/2020 06:58:13,203886,221789,17903,754
6193,10/09/2020 15:01:38,10/09/2020 15:01:41,10/09/2020 16:54:06,10/09/2020 16:54:22,112665,119150,6485,112
6168,10/09/2020 22:10:52,10/09/2020 22:10:54,11/09/2020 05:23:23,11/09/2020 09:20:10,273174199,273197176,22977,669
6132,10/09/2020 22:00:46,10/09/2020 22:00:46,10/09/2020 22:00:46,11/09/2020 07:09:49,1027712,1027761,49,549
6118,11/09/2020 18:32:08,11/09/2020 18:32:12,11/09/2020 22:53:05,11/09/2020 22:53:11,816208,831012,14804,261
6120,11/09/2020 17:44:10,11/09/2020 17:44:14,11/09/2020 20:59:26,12/09/2020 07:53:42,221966,231920,9954,849
6132,11/09/2020 22:01:24,11/09/2020 22:01:25,12/09/2020 03:22:50,12/09/2020 09:12:51,1027833,1044989,17156,671
6136,12/09/2020 09:39:06,12/09/2020 09:39:07,12/09/2020 10:54:13,12/09/2020 10:54:15,469651,473921,4270,75
6116,12/09/2020 11:03:44,12/09/2020 11:03:46,12/09/2020 14:27:59,12/09/2020 14:28:02,236546,249457,12911,204
6168,12/09/2020 14:45:24,12/09/2020 14:45:26,12/09/2020 22:01:39,12/09/2020 22:41:55,273197252,273220582,23330,476
6118,12/09/2020 19:43:53,12/09/2020 19:43:56,13/09/2020 05:29:58,13/09/2020 05:49:32,831116,840646,9530,605
6136,13/09/2020 08:53:56,13/09/2020 08:54:00,13/09/2020 13:52:21,13/09/2020 14:28:10,474031,492330,18299,334
6132,12/09/2020 21:52:57,12/09/2020 21:52:58,13/09/2020 04:06:16,13/09/2020 09:24:36,1045050,1065523,20473,691
6115,13/09/2020 11:35:40,13/09/2020 11:35:41,13/09/2020 15:12:59,13/09/2020 15:13:05,106680,119597,12917,217
6132,13/09/2020 20:35:07,13/09/2020 20:35:07,13/09/2020 20:35:07,13/09/2020 20:36:34,1065577,1065577,0,1
6132,13/09/2020 20:36:51,13/09/2020 20:36:51,13/09/2020 20:36:51,13/09/2020 20:38:10,1065577,1065577,0,1
6118,13/09/2020 18:48:33,13/09/2020 18:48:38,13/09/2020 23:21:31,14/09/2020 06:12:36,840722,856246,15524,684
6132,13/09/2020 20:38:33,13/09/2020 20:38:34,14/09/2020 07:19:06,14/09/2020 07:19:43,1065577,1103466,37889,641
6168,14/09/2020 12:30:18,14/09/2020 12:30:20,14/09/2020 22:25:46,15/09/2020 07:42:48,273220688,273253731,33043,1152
6155,14/09/2020 18:14:14,14/09/2020 18:14:15,14/09/2020 20:17:48,14/09/2020 20:17:51,271609555,271611728,2173,123
6193,15/09/2020 10:15:20,15/09/2020 10:15:25,15/09/2020 12:29:42,15/09/2020 12:46:01,119377,126588,7211,150
6132,15/09/2020 19:09:15,15/09/2020 19:09:16,15/09/2020 23:30:49,16/09/2020 06:16:35,1103640,1117014,13374,667
6119,17/09/2020 10:31:36,17/09/2020 10:31:37,17/09/2020 16:59:41,17/09/2020 16:59:47,324948,335627,10679,388
6132,17/09/2020 18:38:11,17/09/2020 18:38:12,17/09/2020 20:56:35,17/09/2020 20:56:37,1117191,1124979,7788,138
6100,17/09/2020 23:28:25,17/09/2020 23:28:39,17/09/2020 23:28:40,17/09/2020 23:29:45,246347,246352,5,1
6100,17/09/2020 23:29:59,17/09/2020 23:30:00,18/09/2020 01:00:31,18/09/2020 01:00:31,246352,251517,5165,90
6132,17/09/2020 22:03:11,17/09/2020 22:03:12,18/09/2020 01:53:35,18/09/2020 06:17:24,1124985,1136296,11311,494
6132,18/09/2020 06:46:14,18/09/2020 06:46:15,18/09/2020 07:17:42,18/09/2020 07:18:06,1136298,1138145,1847,31
6116,18/09/2020 10:16:39,18/09/2020 10:16:41,18/09/2020 13:37:04,18/09/2020 14:01:11,250161,262905,12744,224
6136,18/09/2020 07:35:44,18/09/2020 07:35:46,18/09/2020 15:54:12,18/09/2020 15:54:34,492892,522885,29993,498
6193,18/09/2020 15:36:46,18/09/2020 15:36:50,18/09/2020 17:28:39,18/09/2020 17:29:49,126739,133238,6499,113
6143,18/09/2020 14:49:31,18/09/2020 14:49:32,18/09/2020 17:47:36,18/09/2020 17:47:38,554077,563884,9807,178
6136,18/09/2020 22:00:03,18/09/2020 22:00:05,19/09/2020 07:39:26,19/09/2020 07:39:28,522915,556035,33120,579
6136,19/09/2020 09:56:10,19/09/2020 09:56:14,19/09/2020 15:59:24,19/09/2020 16:04:34,556047,578611,22564,368
6132,19/09/2020 10:06:05,19/09/2020 10:06:06,19/09/2020 11:24:20,19/09/2020 11:24:22,1138276,1140359,2083,78
6120,19/09/2020 14:01:29,19/09/2020 14:01:33,19/09/2020 15:14:18,19/09/2020 15:14:28,232883,237476,4593,72
6168,19/09/2020 18:58:15,19/09/2020 18:58:17,20/09/2020 03:01:45,20/09/2020 15:40:50,273253958,273280446,26488,1242
6120,19/09/2020 15:43:31,19/09/2020 15:43:35,19/09/2020 19:10:30,19/09/2020 19:50:27,237478,247923,10445,246
6119,19/09/2020 12:49:36,19/09/2020 12:49:37,19/09/2020 20:59:42,19/09/2020 20:59:44,336146,362506,26360,490
6132,19/09/2020 17:06:41,19/09/2020 17:06:42,19/09/2020 22:14:52,20/09/2020 09:13:28,1140387,1156622,16235,966
6136,19/09/2020 18:17:03,19/09/2020 18:17:04,20/09/2020 10:32:02,20/09/2020 10:32:04,578622,582529,3907,975
6120,20/09/2020 15:51:51,20/09/2020 15:51:56,20/09/2020 17:57:13,20/09/2020 18:27:33,248025,255031,7006,155
6100,20/09/2020 16:52:52,20/09/2020 16:52:55,20/09/2020 20:17:11,20/09/2020 20:17:13,251840,260909,9069,204
6116,21/09/2020 08:42:27,21/09/2020 08:42:29,21/09/2020 12:15:54,21/09/2020 13:10:31,263241,276790,13549,268
6118,22/09/2020 07:34:59,22/09/2020 07:35:02,22/09/2020 13:45:04,22/09/2020 13:50:25,857366,866345,8979,375
6155,22/09/2020 17:00:40,22/09/2020 17:00:41,22/09/2020 18:32:24,22/09/2020 18:32:26,271612290,271613250,960,91
6132,22/09/2020 18:06:49,22/09/2020 18:06:50,22/09/2020 20:47:46,22/09/2020 20:47:48,1156899,1164062,7163,160
6120,22/09/2020 18:26:05,22/09/2020 18:26:10,22/09/2020 22:07:26,23/09/2020 07:15:07,255277,266361,11084,769
6193,23/09/2020 09:28:12,23/09/2020 09:28:16,23/09/2020 11:29:41,23/09/2020 11:29:46,133463,140481,7018,121
6118,23/09/2020 09:33:38,23/09/2020 09:33:52,23/09/2020 10:29:03,23/09/2020 12:57:07,866460,869744,3284,203
6116,23/09/2020 10:58:15,23/09/2020 10:58:17,23/09/2020 13:14:52,23/09/2020 14:18:00,277020,285692,8672,199
6118,23/09/2020 14:53:04,23/09/2020 14:53:08,23/09/2020 19:59:57,23/09/2020 20:08:54,869755,878395,8640,315
6136,23/09/2020 12:47:16,23/09/2020 12:47:18,23/09/2020 16:29:04,23/09/2020 16:29:42,582898,596005,13107,222
6126,23/09/2020 21:30:45,23/09/2020 21:30:46,23/09/2020 23:30:58,23/09/2020 23:30:58,80515,87378,6863,120
6151,24/09/2020 10:45:20,24/09/2020 10:46:16,24/09/2020 10:48:56,24/09/2020 10:51:08,101147998,101148133,135,5
6151,24/09/2020 10:51:30,24/09/2020 10:51:33,24/09/2020 12:04:30,24/09/2020 12:27:49,101148133,101151851,3718,96
6132,24/09/2020 18:08:12,24/09/2020 18:08:13,24/09/2020 20:21:07,24/09/2020 20:21:09,1164283,1169642,5359,132
6132,24/09/2020 20:41:10,24/09/2020 20:41:11,24/09/2020 23:17:07,25/09/2020 06:30:44,1169643,1176403,6760,589
6118,25/09/2020 09:36:48,25/09/2020 09:36:52,25/09/2020 12:32:28,25/09/2020 12:32:30,878595,886240,7645,175
6138,25/09/2020 08:03:31,25/09/2020 08:03:38,25/09/2020 11:57:10,25/09/2020 12:11:12,0,0,0,247
6116,25/09/2020 14:44:42,25/09/2020 14:44:44,25/09/2020 17:28:44,25/09/2020 18:18:20,285938,296351,10413,213
6132,25/09/2020 22:11:50,25/09/2020 22:11:51,26/09/2020 03:20:37,26/09/2020 09:02:13,1176479,1192834,16355,650
6115,24/09/2020 15:13:52,24/09/2020 15:13:53,25/09/2020 03:29:00,26/09/2020 09:48:46,120903,165289,44386,2554
6118,26/09/2020 00:12:25,26/09/2020 00:12:29,26/09/2020 03:42:47,26/09/2020 11:12:13,886309,896515,10206,659
6143,26/09/2020 11:18:39,26/09/2020 11:18:44,26/09/2020 13:50:38,26/09/2020 13:50:57,564783,574254,9471,152
6193,26/09/2020 10:20:29,26/09/2020 10:20:33,26/09/2020 12:27:56,26/09/2020 12:28:07,140623,147621,6998,127
6132,26/09/2020 11:06:53,26/09/2020 11:06:56,26/09/2020 13:19:38,26/09/2020 13:20:23,1192844,1200903,8059,133
6136,26/09/2020 09:17:53,26/09/2020 09:17:55,26/09/2020 13:27:44,26/09/2020 13:28:43,596327,611127,14800,250
6143,26/09/2020 15:43:12,26/09/2020 15:43:16,26/09/2020 18:44:47,26/09/2020 18:44:49,574263,585222,10959,181
6182,26/09/2020 16:04:19,26/09/2020 16:04:23,26/09/2020 16:28:28,26/09/2020 16:29:30,273000832,273002157,1325,25
6100,26/09/2020 14:53:02,26/09/2020 14:53:06,26/09/2020 18:03:41,26/09/2020 18:03:43,261608,270476,8868,190
6182,26/09/2020 16:30:15,26/09/2020 16:30:19,26/09/2020 19:05:05,26/09/2020 19:05:16,273002157,273010768,8611,155
6168,26/09/2020 19:15:59,26/09/2020 19:16:01,27/09/2020 03:47:38,27/09/2020 09:45:43,273280754,273308294,27540,869
6132,26/09/2020 21:09:02,26/09/2020 21:09:03,27/09/2020 00:10:49,27/09/2020 09:11:59,1200941,1209364,8423,722
6118,26/09/2020 19:50:12,26/09/2020 19:50:15,27/09/2020 00:06:26,27/09/2020 13:24:43,896566,910299,13733,1054
6116,27/09/2020 09:32:25,27/09/2020 09:32:27,27/09/2020 11:49:23,27/09/2020 13:55:32,296550,305207,8657,263
6136,27/09/2020 14:41:07,27/09/2020 14:41:12,27/09/2020 18:43:52,27/09/2020 18:43:52,611252,626480,15228,242
6132,27/09/2020 13:16:43,27/09/2020 13:16:51,27/09/2020 15:05:05,27/09/2020 15:05:08,1209383,1215203,5820,108
6151,27/09/2020 16:02:26,27/09/2020 16:02:32,27/09/2020 17:59:03,27/09/2020 19:40:25,101152048,101158742,6694,217
6138,27/09/2020 15:28:25,27/09/2020 15:28:26,27/09/2020 16:07:08,27/09/2020 16:07:10,0,0,0,38
6132,27/09/2020 16:24:38,27/09/2020 16:24:39,27/09/2020 22:08:37,28/09/2020 06:08:15,1215210,1232872,17662,823
6118,28/09/2020 07:33:07,28/09/2020 07:33:10,28/09/2020 11:24:12,28/09/2020 11:24:23,910407,915740,5333,231
6182,28/09/2020 18:20:46,28/09/2020 18:20:52,28/09/2020 22:42:40,28/09/2020 22:42:57,273010868,273025668,14800,262
6118,29/09/2020 09:51:34,29/09/2020 09:51:38,29/09/2020 12:59:48,29/09/2020 13:22:26,915867,924592,8725,210
6143,29/09/2020 12:21:09,29/09/2020 12:21:10,29/09/2020 18:25:53,29/09/2020 18:25:55,585541,587235,1694,364
6132,29/09/2020 18:48:40,29/09/2020 18:48:41,29/09/2020 20:59:53,29/09/2020 21:12:49,1233051,1239704,6653,144
6118,30/09/2020 07:28:02,30/09/2020 07:28:06,30/09/2020 10:29:59,30/09/2020 10:53:30,924685,931165,6480,205
6193,30/09/2020 14:56:49,30/09/2020 14:56:54,30/09/2020 17:20:16,30/09/2020 17:20:26,147818,155130,7312,143
6118,30/09/2020 18:51:51,30/09/2020 18:51:52,30/09/2020 20:47:03,30/09/2020 20:47:05,931211,937494,6283,115
6119,30/09/2020 15:09:28,30/09/2020 15:09:29,30/09/2020 21:24:20,30/09/2020 21:24:22,364988,385277,20289,374
6132,30/09/2020 22:04:25,30/09/2020 22:04:26,01/10/2020 06:24:03,01/10/2020 06:24:16,1239831,1270605,30774,499
6118,01/10/2020 07:36:04,01/10/2020 07:36:08,01/10/2020 13:30:00,01/10/2020 13:30:26,937554,945561,8007,354
6101,01/10/2020 18:15:55,01/10/2020 18:15:59,01/10/2020 19:36:42,01/10/2020 19:37:57,126919,131806,4887,82
6168,01/10/2020 22:10:25,01/10/2020 22:10:27,02/10/2020 07:55:33,02/10/2020 11:42:00,273308512,273340579,32067,811
6132,01/10/2020 20:20:40,01/10/2020 20:20:41,02/10/2020 04:16:47,02/10/2020 06:08:08,1270672,1297152,26480,587
6119,01/10/2020 07:01:30,01/10/2020 07:01:31,02/10/2020 00:17:19,02/10/2020 06:48:00,385324,446615,61291,1426
6118,02/10/2020 09:50:29,02/10/2020 09:50:33,02/10/2020 13:30:00,02/10/2020 13:46:19,945665,954223,8558,235
6197,02/10/2020 12:10:50,02/10/2020 12:10:51,02/10/2020 12:13:30,02/10/2020 12:13:32,1285,1360,75,2
6197,02/10/2020 12:35:47,02/10/2020 12:35:48,02/10/2020 12:39:33,02/10/2020 12:39:36,1361,1465,104,3
6197,02/10/2020 12:41:22,02/10/2020 12:41:23,02/10/2020 12:53:32,02/10/2020 12:53:34,1465,1809,344,12
6197,02/10/2020 12:58:09,02/10/2020 12:58:10,02/10/2020 13:05:39,02/10/2020 13:05:41,1810,1995,185,7
6197,02/10/2020 13:20:34,02/10/2020 13:20:35,02/10/2020 13:21:14,02/10/2020 13:21:16,1986,2003,17,0
6197,02/10/2020 13:23:36,02/10/2020 13:23:37,02/10/2020 13:25:09,02/10/2020 13:25:11,2003,2045,42,1
6197,02/10/2020 13:29:39,02/10/2020 13:29:40,02/10/2020 13:33:45,02/10/2020 13:33:47,2045,2163,118,4
6101,02/10/2020 07:59:59,02/10/2020 08:00:06,02/10/2020 13:42:13,02/10/2020 13:47:44,131867,149724,17857,347
6197,02/10/2020 14:48:29,02/10/2020 14:48:30,02/10/2020 14:50:18,02/10/2020 14:50:20,2166,2217,51,1
6197,02/10/2020 14:58:01,02/10/2020 14:58:02,02/10/2020 14:58:40,02/10/2020 14:58:42,2218,2235,17,0
6197,02/10/2020 15:00:49,02/10/2020 15:00:50,02/10/2020 15:02:54,02/10/2020 15:02:56,2235,2292,57,2
6169,02/10/2020 11:01:48,02/10/2020 11:01:50,02/10/2020 17:39:49,02/10/2020 17:40:15,273107635,273131432,23797,398
6120,02/10/2020 18:56:14,02/10/2020 18:56:18,02/10/2020 20:23:19,02/10/2020 20:24:16,267580,273218,5638,88
6120,02/10/2020 20:25:47,02/10/2020 20:25:52,02/10/2020 20:31:59,02/10/2020 20:32:44,273218,273604,386,6
6127,02/10/2020 16:44:46,02/10/2020 16:44:50,02/10/2020 21:12:32,02/10/2020 21:13:17,59666,76702,17036,268
6132,02/10/2020 23:06:10,02/10/2020 23:06:12,03/10/2020 07:55:48,03/10/2020 09:12:22,1297235,1327834,30599,606
6151,03/10/2020 08:36:09,03/10/2020 08:36:15,03/10/2020 11:01:35,03/10/2020 11:01:35,101159048,101160839,1791,145
6151,03/10/2020 12:21:41,03/10/2020 12:23:35,03/10/2020 15:45:02,03/10/2020 15:45:02,101160846,101171403,10557,203
6169,03/10/2020 15:30:46,03/10/2020 15:30:48,03/10/2020 19:21:48,03/10/2020 20:20:03,273131482,273141648,10166,289
6132,03/10/2020 17:42:28,03/10/2020 17:42:30,04/10/2020 01:49:49,04/10/2020 11:33:09,1327875,1355118,27243,1070
6146,03/10/2020 14:30:20,03/10/2020 14:30:23,03/10/2020 17:48:13,03/10/2020 17:48:15,92793,101335,8542,197
6100,03/10/2020 15:08:03,03/10/2020 15:08:07,03/10/2020 18:30:46,03/10/2020 18:30:48,271305,280476,9171,202
6115,03/10/2020 10:19:14,03/10/2020 10:19:15,03/10/2020 21:28:47,04/10/2020 09:43:27,166122,205209,39087,1404
6118,03/10/2020 17:26:35,03/10/2020 17:26:39,03/10/2020 21:52:07,04/10/2020 11:11:46,954386,968516,14130,1065
6143,04/10/2020 12:22:12,04/10/2020 12:22:16,04/10/2020 14:23:27,04/10/2020 14:23:27,587793,595144,7351,121
6143,04/10/2020 15:25:21,04/10/2020 15:25:25,04/10/2020 19:16:57,04/10/2020 19:16:57,595150,609178,14028,231
6177,04/10/2020 11:53:11,04/10/2020 11:53:16,04/10/2020 15:56:56,04/10/2020 15:57:02,35473,49193,13720,243
6118,04/10/2020 19:20:02,04/10/2020 19:20:05,05/10/2020 06:44:50,05/10/2020 06:45:08,968556,979500,10944,685
6151,05/10/2020 16:05:45,05/10/2020 16:05:54,05/10/2020 19:29:54,05/10/2020 19:45:27,101171511,101182741,11230,219
6118,05/10/2020 18:21:53,05/10/2020 18:21:55,05/10/2020 20:54:59,05/10/2020 20:55:01,979568,985194,5626,153
6118,06/10/2020 07:27:25,06/10/2020 07:27:33,06/10/2020 13:30:02,06/10/2020 13:38:26,985249,993909,8660,371
6115,04/10/2020 16:05:39,04/10/2020 16:05:40,05/10/2020 10:29:03,06/10/2020 11:09:29,205240,270414,65174,2583
6116,06/10/2020 09:07:58,06/10/2020 09:08:00,06/10/2020 12:31:08,06/10/2020 13:07:34,306270,319146,12876,239
6132,06/10/2020 16:50:14,06/10/2020 16:50:15,06/10/2020 18:14:39,06/10/2020 18:14:41,1355379,1360221,4842,84
6193,07/10/2020 08:43:24,07/10/2020 08:43:29,07/10/2020 10:58:33,07/10/2020 11:25:00,155449,162699,7250,161
6168,07/10/2020 13:00:13,07/10/2020 13:00:15,07/10/2020 18:01:21,07/10/2020 18:01:21,273340829,273358885,18056,301
6151,07/10/2020 11:14:33,07/10/2020 11:14:34,07/10/2020 19:06:12,07/10/2020 19:06:14,101182841,101197972,15131,471
6153,07/10/2020 20:00:46,07/10/2020 20:00:51,07/10/2020 20:57:33,07/10/2020 20:58:58,282589919,282591601,1682,58
6132,07/10/2020 21:43:30,07/10/2020 21:43:32,08/10/2020 04:02:19,08/10/2020 07:59:42,1360356,1380967,20611,616
6116,08/10/2020 08:02:28,08/10/2020 08:02:30,08/10/2020 11:31:59,08/10/2020 12:47:37,319363,332564,13201,285
6100,08/10/2020 23:35:55,08/10/2020 23:35:56,08/10/2020 23:37:25,08/10/2020 23:37:30,281106,281148,42,1
6132,08/10/2020 23:04:53,08/10/2020 23:04:54,09/10/2020 06:30:24,09/10/2020 06:30:35,1381041,1409203,28162,445
6100,08/10/2020 23:38:19,08/10/2020 23:38:20,09/10/2020 02:11:56,09/10/2020 11:37:19,281148,285773,4625,719
6136,09/10/2020 07:51:13,09/10/2020 07:51:14,09/10/2020 11:53:14,09/10/2020 11:53:16,627856,641756,13900,242
6138,09/10/2020 07:57:38,09/10/2020 07:57:45,09/10/2020 12:36:28,09/10/2020 13:19:50,0,0,0,322
6126,09/10/2020 13:22:26,09/10/2020 13:22:27,09/10/2020 13:22:28,09/10/2020 13:23:20,89238,89242,4,0
6126,09/10/2020 13:23:46,09/10/2020 13:25:18,09/10/2020 15:06:30,09/10/2020 16:45:34,89242,94007,4765,201
6132,09/10/2020 15:17:21,09/10/2020 15:17:23,10/10/2020 00:14:08,10/10/2020 11:25:30,1409246,1439222,29976,1208
6168,09/10/2020 19:37:28,09/10/2020 19:37:30,10/10/2020 06:03:04,10/10/2020 11:04:56,273358994,273393745,34751,927
6126,09/10/2020 23:21:48,09/10/2020 23:21:49,10/10/2020 00:41:01,10/10/2020 00:41:01,94040,96455,2415,79
6118,10/10/2020 07:31:19,10/10/2020 07:31:20,10/10/2020 10:07:59,10/10/2020 10:08:01,994417,1002112,7695,156
6136,10/10/2020 10:11:05,10/10/2020 10:11:06,10/10/2020 12:11:07,10/10/2020 12:11:09,641867,648670,6803,120
6118,10/10/2020 13:47:13,10/10/2020 13:47:17,10/10/2020 17:38:30,10/10/2020 17:38:40,1002130,1010821,8691,231
6151,10/10/2020 14:47:57,10/10/2020 14:48:03,10/10/2020 17:29:05,10/10/2020 17:52:37,101198106,101207359,9253,184
6115,10/10/2020 16:17:42,10/10/2020 16:17:48,10/10/2020 17:13:20,10/10/2020 17:13:23,270915,273034,2119,55
6193,10/10/2020 15:52:23,10/10/2020 15:52:27,10/10/2020 17:56:42,10/10/2020 18:11:59,162854,169561,6707,139
6132,10/10/2020 18:28:22,10/10/2020 18:28:32,11/10/2020 07:28:09,11/10/2020 18:04:16,1439256,1485897,46641,1415
6118,11/10/2020 06:24:48,11/10/2020 06:24:52,11/10/2020 08:24:32,11/10/2020 08:24:35,1010887,1018050,7163,119
6127,11/10/2020 09:42:19,11/10/2020 09:42:24,11/10/2020 15:01:29,11/10/2020 15:01:29,77714,98152,20438,319
6118,11/10/2020 11:44:49,11/10/2020 11:44:50,11/10/2020 14:29:05,11/10/2020 14:47:49,1018067,1025315,7248,183
6175,11/10/2020 17:54:56,11/10/2020 17:55:00,11/10/2020 19:29:09,11/10/2020 19:30:10,274486525,274491961,5436,95
6132,11/10/2020 18:33:54,11/10/2020 18:33:55,12/10/2020 02:47:08,12/10/2020 06:57:21,1485899,1513247,27348,743
6175,11/10/2020 19:30:36,11/10/2020 19:30:39,11/10/2020 20:05:53,11/10/2020 20:05:53,274491961,274493857,1896,35
6100,11/10/2020 17:15:46,11/10/2020 17:15:49,11/10/2020 21:29:55,11/10/2020 21:34:20,286042,295173,9131,258
6118,11/10/2020 14:48:33,11/10/2020 14:48:33,11/10/2020 22:29:01,11/10/2020 22:52:46,1025315,1042007,16692,484
6169,12/10/2020 07:21:17,12/10/2020 07:21:19,12/10/2020 09:41:41,12/10/2020 17:39:05,273142081,273146700,4619,617
6118,12/10/2020 07:34:41,12/10/2020 07:34:59,12/10/2020 11:14:18,12/10/2020 11:14:20,1042054,1050621,8567,219
6175,12/10/2020 14:06:16,12/10/2020 14:06:19,12/10/2020 17:24:07,12/10/2020 17:25:25,274493894,274505416,11522,199
6118,12/10/2020 12:58:56,12/10/2020 12:58:57,12/10/2020 14:17:43,12/10/2020 14:30:50,1050631,1054007,3376,91
6132,12/10/2020 15:00:45,12/10/2020 15:00:47,12/10/2020 22:16:27,13/10/2020 06:21:14,1513286,1536742,23456,920
6175,12/10/2020 17:25:34,12/10/2020 17:25:39,12/10/2020 19:15:53,12/10/2020 19:16:12,274505416,274511828,6412,110
6118,12/10/2020 17:48:56,12/10/2020 17:48:57,12/10/2020 19:51:11,12/10/2020 19:51:13,1054024,1059895,5871,122
6175,12/10/2020 20:15:31,12/10/2020 20:15:35,12/10/2020 20:50:47,12/10/2020 20:50:49,274511831,274513834,2003,35
6107,13/10/2020 07:13:12,13/10/2020 07:13:17,13/10/2020 08:11:48,13/10/2020 08:11:55,68025,71763,3738,58
6197,13/10/2020 11:04:04,13/10/2020 11:04:05,13/10/2020 11:06:10,13/10/2020 11:06:12,2625,2656,31,2
6197,13/10/2020 11:11:54,13/10/2020 11:11:55,13/10/2020 11:16:03,13/10/2020 11:16:05,2657,2718,61,4
6136,13/10/2020 11:54:18,13/10/2020 11:54:19,13/10/2020 11:55:07,13/10/2020 11:55:09,649025,649063,38,0
6132,13/10/2020 15:12:16,13/10/2020 15:12:18,13/10/2020 23:32:23,14/10/2020 06:20:57,1536785,1564501,27716,908
6118,13/10/2020 18:06:50,13/10/2020 18:06:51,13/10/2020 20:26:27,13/10/2020 20:26:28,1060019,1066350,6331,139
6175,13/10/2020 20:40:51,13/10/2020 20:40:56,14/10/2020 06:26:28,14/10/2020 06:27:04,274513882,274527429,13547,586
6126,13/10/2020 22:08:50,13/10/2020 22:08:51,14/10/2020 00:29:36,14/10/2020 01:11:03,96923,101119,4196,182
6118,13/10/2020 21:03:30,13/10/2020 21:03:35,14/10/2020 02:20:51,14/10/2020 05:20:35,1066353,1083442,17089,497
6118,14/10/2020 07:46:45,14/10/2020 07:47:13,14/10/2020 11:07:58,14/10/2020 11:08:01,1083454,1092023,8569,201
6136,14/10/2020 11:38:57,14/10/2020 11:38:58,14/10/2020 11:39:50,14/10/2020 11:39:52,649180,649224,44,0
6138,14/10/2020 08:00:57,14/10/2020 08:01:05,14/10/2020 11:37:56,14/10/2020 12:00:09,0,0,0,239
6136,14/10/2020 11:41:36,14/10/2020 11:41:38,14/10/2020 13:03:09,14/10/2020 13:04:25,649224,654073,4849,82
6115,14/10/2020 12:13:58,14/10/2020 12:13:59,14/10/2020 17:13:55,14/10/2020 17:14:41,273485,292813,19328,300
6132,14/10/2020 14:59:06,14/10/2020 14:59:08,14/10/2020 22:51:33,15/10/2020 06:10:47,1564542,1590292,25750,911
6169,15/10/2020 08:59:01,15/10/2020 08:59:03,15/10/2020 11:15:33,15/10/2020 17:45:44,273146834,273151369,4535,526
6136,14/10/2020 13:44:12,14/10/2020 13:44:13,15/10/2020 10:25:06,15/10/2020 10:25:06,654076,655281,1205,1240
6136,15/10/2020 10:47:31,15/10/2020 10:47:32,16/10/2020 12:36:41,16/10/2020 12:36:43,655283,656218,935,1549
6193,15/10/2020 08:26:46,15/10/2020 08:26:52,15/10/2020 10:37:45,15/10/2020 10:50:36,169782,176848,7066,143
6118,15/10/2020 15:10:21,15/10/2020 15:10:25,15/10/2020 18:29:58,15/10/2020 18:32:37,1092174,1099821,7647,202
6132,15/10/2020 18:11:33,15/10/2020 18:11:35,16/10/2020 02:51:10,16/10/2020 06:07:10,1590351,1619629,29278,715
6169,15/10/2020 18:55:52,15/10/2020 18:58:06,16/10/2020 00:32:35,16/10/2020 06:18:09,273151372,273171359,19987,682
6119,15/10/2020 16:19:46,15/10/2020 16:19:47,16/10/2020 09:02:19,16/10/2020 09:54:31,448763,508631,59868,1054
6143,16/10/2020 08:33:42,16/10/2020 08:33:49,16/10/2020 10:00:37,16/10/2020 10:00:46,618400,623541,5141,87
6136,16/10/2020 12:49:55,16/10/2020 12:49:56,16/10/2020 20:44:37,16/10/2020 20:44:39,656219,656802,583,474
6132,16/10/2020 16:20:35,16/10/2020 16:20:37,16/10/2020 23:05:48,17/10/2020 11:20:45,1619678,1641318,21640,1140
6136,16/10/2020 20:45:28,16/10/2020 20:45:29,17/10/2020 07:51:50,17/10/2020 07:51:50,656802,657317,515,666
6175,16/10/2020 21:38:47,16/10/2020 21:38:52,17/10/2020 04:20:07,17/10/2020 07:19:07,274527554,274546827,19273,580
6168,16/10/2020 22:24:33,16/10/2020 22:24:35,17/10/2020 07:15:54,17/10/2020 12:44:25,273394063,273422912,28849,859
6136,17/10/2020 08:09:00,17/10/2020 08:09:01,17/10/2020 12:18:18,17/10/2020 12:18:18,657318,657786,468,249
6143,17/10/2020 09:46:40,17/10/2020 09:46:46,17/10/2020 12:46:37,17/10/2020 12:46:37,623657,634579,10922,179
6136,17/10/2020 12:19:00,17/10/2020 12:19:01,17/10/2020 13:59:18,17/10/2020 13:59:18,657786,658198,412,100
6143,17/10/2020 14:05:48,17/10/2020 14:05:49,17/10/2020 17:23:23,17/10/2020 17:23:25,634586,634981,395,197
6136,17/10/2020 14:29:21,17/10/2020 14:29:25,17/10/2020 16:25:29,17/10/2020 16:25:29,658201,665447,7246,116
6143,17/10/2020 17:24:09,17/10/2020 17:24:10,18/10/2020 07:51:50,18/10/2020 07:51:50,634981,635760,779,867
6132,17/10/2020 18:35:25,17/10/2020 18:35:27,18/10/2020 00:24:53,19/10/2020 06:14:59,1641353,1660028,18675,2139
6136,17/10/2020 16:47:20,17/10/2020 16:47:21,18/10/2020 07:20:38,18/10/2020 07:20:40,665450,698258,32808,873
6143,18/10/2020 07:52:11,18/10/2020 07:52:12,18/10/2020 11:41:43,18/10/2020 11:41:43,635760,635897,137,229
6104,18/10/2020 08:56:49,18/10/2020 08:56:53,18/10/2020 11:36:20,18/10/2020 11:36:37,69656,79459,9803,159
6143,18/10/2020 11:42:02,18/10/2020 11:42:03,18/10/2020 14:31:28,18/10/2020 14:31:28,635897,635981,84,169
6136,18/10/2020 12:36:48,18/10/2020 12:36:53,18/10/2020 15:55:50,18/10/2020 16:14:20,698284,709963,11679,217
6119,18/10/2020 08:33:30,18/10/2020 08:33:31,18/10/2020 20:46:16,18/10/2020 20:54:58,509050,547578,38528,741
6132,19/10/2020 14:43:27,19/10/2020 14:43:29,19/10/2020 20:30:47,20/10/2020 06:28:20,1660069,1678343,18274,944
6175,19/10/2020 16:22:22,19/10/2020 16:22:26,19/10/2020 19:21:31,19/10/2020 19:22:13,274546940,274557334,10394,179
6118,19/10/2020 18:15:27,19/10/2020 18:16:21,19/10/2020 21:22:43,19/10/2020 21:22:46,1100341,1108636,8295,187
6118,20/10/2020 07:15:43,20/10/2020 07:15:44,20/10/2020 10:29:02,20/10/2020 10:35:43,1108694,1115703,7009,200
6101,20/10/2020 08:17:36,20/10/2020 08:20:45,20/10/2020 08:20:46,20/10/2020 10:30:00,151836,151851,15,132
6101,20/10/2020 11:59:39,20/10/2020 11:59:50,20/10/2020 15:58:53,20/10/2020 15:58:56,151862,164542,12680,239
6118,20/10/2020 10:36:20,20/10/2020 10:36:21,20/10/2020 12:59:05,20/10/2020 13:02:58,1115703,1123177,7474,146
6151,20/10/2020 14:47:15,20/10/2020 14:47:21,20/10/2020 17:29:02,20/10/2020 17:57:25,101207854,101217214,9360,190
6132,20/10/2020 14:47:54,20/10/2020 14:47:56,20/10/2020 20:54:08,21/10/2020 06:16:31,1678383,1697893,19510,928
6118,20/10/2020 13:03:42,20/10/2020 13:03:43,20/10/2020 14:59:01,20/10/2020 15:08:04,1123177,1130577,7400,124
6118,20/10/2020 15:08:39,20/10/2020 15:08:40,20/10/2020 16:59:03,20/10/2020 17:02:30,1130577,1137632,7055,113
6175,20/10/2020 20:58:45,20/10/2020 20:58:51,21/10/2020 03:20:33,21/10/2020 06:37:15,274557384,274576130,18746,578
6169,21/10/2020 06:40:40,21/10/2020 06:40:42,21/10/2020 12:19:00,21/10/2020 16:56:59,273171607,273187616,16009,616
6118,21/10/2020 10:38:00,21/10/2020 10:38:04,21/10/2020 13:39:50,21/10/2020 13:39:52,1137730,1146212,8482,181
6132,21/10/2020 14:53:20,21/10/2020 14:53:22,21/10/2020 21:10:27,22/10/2020 05:39:35,1697935,1718007,20072,886
6118,21/10/2020 13:55:15,21/10/2020 13:55:16,21/10/2020 15:29:01,21/10/2020 16:06:37,1146213,1151846,5633,131
6174,21/10/2020 11:12:00,21/10/2020 11:12:05,21/10/2020 18:01:22,21/10/2020 18:01:47,272985775,273009534,23759,409
6118,21/10/2020 17:23:12,21/10/2020 17:23:13,21/10/2020 19:45:17,21/10/2020 19:45:19,1151853,1158733,6880,142
6132,22/10/2020 14:50:59,22/10/2020 14:51:01,22/10/2020 21:25:19,23/10/2020 06:00:02,1718051,1739556,21505,909
6118,22/10/2020 19:11:13,22/10/2020 19:11:15,22/10/2020 20:34:37,22/10/2020 20:34:39,1158871,1163801,4930,83
6168,22/10/2020 21:24:14,22/10/2020 21:24:16,23/10/2020 07:26:44,23/10/2020 07:32:04,273423174,273456379,33205,607
6155,22/10/2020 21:51:37,22/10/2020 21:51:42,22/10/2020 23:08:00,22/10/2020 23:08:22,271615407,271619517,4110,76
6118,23/10/2020 07:24:45,23/10/2020 07:25:02,23/10/2020 11:00:00,23/10/2020 11:17:26,1163865,1172287,8422,232
6116,23/10/2020 14:39:45,23/10/2020 14:39:49,23/10/2020 15:57:50,23/10/2020 15:59:00,334389,339209,4820,79
6155,23/10/2020 09:23:49,23/10/2020 09:23:54,23/10/2020 12:45:58,23/10/2020 14:42:35,271619548,271628593,9045,318
6132,23/10/2020 14:42:39,23/10/2020 14:42:41,23/10/2020 20:22:35,24/10/2020 07:44:02,1739598,1757317,17719,1021
6136,23/10/2020 08:21:20,23/10/2020 08:21:22,23/10/2020 15:28:01,23/10/2020 15:29:37,710518,735008,24490,428
6169,23/10/2020 12:11:09,23/10/2020 12:11:13,23/10/2020 16:30:05,23/10/2020 17:47:39,273187708,273202715,15007,336
6142,23/10/2020 18:11:40,23/10/2020 18:18:16,23/10/2020 18:18:18,23/10/2020 18:18:51,458774,458774,0,7
6175,23/10/2020 21:01:30,23/10/2020 21:01:35,24/10/2020 07:14:33,24/10/2020 07:15:07,274576254,274594239,17985,613
6142,23/10/2020 18:27:47,23/10/2020 18:27:55,23/10/2020 22:05:04,23/10/2020 22:05:39,458775,470804,12029,217
6120,23/10/2020 22:51:53,23/10/2020 22:51:55,23/10/2020 22:53:44,23/10/2020 22:53:46,276293,276403,110,1
6120,23/10/2020 22:55:44,23/10/2020 22:55:46,24/10/2020 07:05:49,24/10/2020 07:06:14,276404,307137,30733,490
6136,23/10/2020 19:44:25,23/10/2020 19:44:26,24/10/2020 08:04:57,24/10/2020 08:04:59,735029,763699,28670,740
6169,24/10/2020 10:40:11,24/10/2020 10:40:13,24/10/2020 16:33:45,24/10/2020 19:07:38,273202752,273219443,16691,507
6155,24/10/2020 10:39:03,24/10/2020 10:39:04,24/10/2020 12:08:13,24/10/2020 12:08:15,271628653,271630331,1678,89
6132,24/10/2020 15:50:30,24/10/2020 15:50:32,24/10/2020 21:17:19,25/10/2020 12:46:11,1757356,1774516,17160,1255
6151,24/10/2020 15:34:55,24/10/2020 15:35:01,24/10/2020 16:29:03,24/10/2020 16:52:24,101217450,101220544,3094,77
6118,24/10/2020 22:20:56,24/10/2020 22:21:00,25/10/2020 02:28:56,25/10/2020 09:21:09,1172494,1185367,12873,660
6127,25/10/2020 11:00:40,25/10/2020 11:00:45,25/10/2020 12:40:15,25/10/2020 12:40:17,143975,150205,6230,99
6193,25/10/2020 12:01:57,25/10/2020 12:02:01,25/10/2020 13:16:48,25/10/2020 13:29:32,177332,181107,3775,87
6184,25/10/2020 13:46:10,25/10/2020 13:46:14,25/10/2020 22:23:24,25/10/2020 22:30:35,15181,45406,30225,524
6106,25/10/2020 13:45:02,25/10/2020 13:45:03,25/10/2020 13:56:15,25/10/2020 13:56:17,42474,43079,605,11
6132,25/10/2020 13:42:53,25/10/2020 13:42:54,25/10/2020 18:00:03,25/10/2020 18:00:12,1774521,1790287,15766,257
6132,25/10/2020 18:29:51,25/10/2020 18:29:53,26/10/2020 01:25:01,26/10/2020 06:52:58,1790289,1813046,22757,743
6115,25/10/2020 18:39:12,25/10/2020 18:39:13,25/10/2020 20:59:11,25/10/2020 20:59:13,294128,302350,8222,140
6119,25/10/2020 12:49:43,25/10/2020 12:49:45,26/10/2020 03:59:26,26/10/2020 07:53:37,549553,602801,53248,1143
6118,26/10/2020 09:46:58,26/10/2020 09:46:59,26/10/2020 13:41:21,26/10/2020 13:41:23,1185507,1192485,6978,234
6106,26/10/2020 09:09:58,26/10/2020 09:09:59,26/10/2020 11:05:42,26/10/2020 11:22:46,43134,49652,6518,132
6132,26/10/2020 15:10:55,26/10/2020 15:10:56,26/10/2020 22:40:35,27/10/2020 06:58:59,1813086,1837524,24438,948
6136,26/10/2020 17:24:05,26/10/2020 17:24:08,26/10/2020 20:47:50,26/10/2020 20:47:50,763984,776788,12804,203
6193,26/10/2020 16:01:46,26/10/2020 16:01:51,26/10/2020 18:10:55,26/10/2020 18:30:54,181160,188148,6988,149
6118,27/10/2020 07:52:52,27/10/2020 07:53:06,27/10/2020 11:27:07,27/10/2020 11:27:09,1192579,1201245,8666,214
6168,27/10/2020 12:57:45,27/10/2020 12:57:47,27/10/2020 20:02:05,27/10/2020 20:03:05,273456606,273478876,22270,425
6118,27/10/2020 14:12:46,27/10/2020 14:12:50,27/10/2020 18:59:59,27/10/2020 19:12:31,1201261,1210342,9081,299
6132,27/10/2020 20:05:31,27/10/2020 20:05:33,28/10/2020 03:57:42,28/10/2020 07:17:40,1837588,1863839,26251,672
6143,28/10/2020 18:14:37,28/10/2020 18:14:41,28/10/2020 20:55:27,28/10/2020 20:55:27,637162,646813,9651,160
6132,28/10/2020 19:36:18,28/10/2020 19:36:20,29/10/2020 03:23:47,29/10/2020 07:24:12,1863899,1889754,25855,707
6175,28/10/2020 22:32:43,28/10/2020 22:32:47,29/10/2020 05:13:39,29/10/2020 11:42:19,274594461,274613883,19422,789
6118,29/10/2020 09:07:37,29/10/2020 09:07:39,29/10/2020 11:22:32,29/10/2020 11:22:34,1210530,1216864,6334,134
6188,29/10/2020 12:34:58,29/10/2020 12:35:00,30/10/2020 03:03:42,30/10/2020 07:32:33,274128433,274177286,48853,1137
6132,29/10/2020 18:58:02,29/10/2020 18:58:04,30/10/2020 03:53:24,30/10/2020 07:05:24,1889779,1919680,29901,727
6175,29/10/2020 21:55:28,29/10/2020 21:55:32,30/10/2020 04:22:11,30/10/2020 07:37:46,274613903,274633240,19337,582
6136,30/10/2020 08:56:56,30/10/2020 08:57:00,30/10/2020 09:18:40,30/10/2020 09:18:40,777139,778475,1336,21
6118,30/10/2020 09:01:26,30/10/2020 09:01:30,30/10/2020 12:36:38,30/10/2020 13:12:04,1216908,1225542,8634,250
6122,25/10/2020 13:17:13,25/10/2020 13:17:16,25/10/2020 13:17:16,25/10/2020 13:17:16,58151,58206,55,0
6106,30/10/2020 09:47:29,30/10/2020 09:47:31,30/10/2020 14:28:20,30/10/2020 14:28:22,49916,56219,6303,280
6168,30/10/2020 14:44:06,30/10/2020 14:44:08,30/10/2020 17:26:26,30/10/2020 17:26:26,273479022,273488708,9686,162
6178,30/10/2020 09:55:48,30/10/2020 09:56:39,30/10/2020 18:58:14,30/10/2020 18:58:41,286524168,286551417,27249,542
6133,30/10/2020 21:01:12,30/10/2020 21:01:17,30/10/2020 21:24:39,30/10/2020 21:24:46,197193,198590,1397,23
6132,30/10/2020 21:32:28,30/10/2020 21:32:29,31/10/2020 07:11:06,31/10/2020 08:39:19,1919709,1952084,32375,666
6118,30/10/2020 19:00:32,30/10/2020 19:00:35,30/10/2020 23:27:33,31/10/2020 00:00:25,1225554,1239926,14372,299
6139,31/10/2020 12:58:02,31/10/2020 12:58:04,31/10/2020 16:24:50,31/10/2020 16:26:47,226721,239503,12782,208
6168,31/10/2020 16:50:58,31/10/2020 16:51:00,31/10/2020 23:47:51,31/10/2020 23:47:51,273488757,273513655,24898,416
6118,31/10/2020 18:00:08,31/10/2020 18:00:12,31/10/2020 18:37:57,31/10/2020 18:38:03,1239964,1242126,2162,37
6132,31/10/2020 20:24:11,31/10/2020 20:24:13,01/11/2020 06:00:08,01/11/2020 11:05:56,1952107,1984466,32359,881
6175,31/10/2020 23:57:37,31/10/2020 23:57:42,01/11/2020 10:51:17,01/11/2020 10:51:19,274633319,274637890,4571,653
6116,01/11/2020 07:48:18,01/11/2020 07:48:20,01/11/2020 09:34:45,01/11/2020 09:35:15,340017,346691,6674,106
6118,01/11/2020 09:39:44,01/11/2020 09:39:46,01/11/2020 11:35:56,01/11/2020 11:35:58,1242151,1248832,6681,116
6175,01/11/2020 10:57:20,01/11/2020 10:57:21,01/11/2020 11:06:29,01/11/2020 11:06:29,274637890,274637894,4,9
6143,01/11/2020 09:16:05,01/11/2020 09:16:06,01/11/2020 13:01:32,01/11/2020 13:01:34,646988,659482,12494,225
6118,01/11/2020 11:40:56,01/11/2020 11:41:00,01/11/2020 13:07:35,01/11/2020 13:07:39,1248832,1254133,5301,86
6143,01/11/2020 14:07:26,01/11/2020 14:07:30,01/11/2020 18:31:24,01/11/2020 18:31:34,659485,675103,15618,264
6118,01/11/2020 13:29:50,01/11/2020 13:29:56,01/11/2020 15:32:29,01/11/2020 15:33:26,1254134,1261702,7568,123
6118,01/11/2020 18:01:45,01/11/2020 18:01:46,01/11/2020 20:45:53,01/11/2020 20:45:55,1261706,1266266,4560,164
6132,01/11/2020 20:17:56,01/11/2020 20:17:58,02/11/2020 03:47:11,02/11/2020 07:06:31,1984484,2009257,24773,648
6100,01/11/2020 17:34:42,01/11/2020 17:34:45,01/11/2020 21:07:16,01/11/2020 21:07:19,297441,306357,8916,212
6118,01/11/2020 22:29:11,01/11/2020 22:29:15,02/11/2020 01:14:18,02/11/2020 05:54:10,1266269,1274416,8147,444
6146,01/11/2020 18:58:07,01/11/2020 18:58:12,02/11/2020 07:35:15,02/11/2020 07:39:14,104561,124228,19667,761
6118,02/11/2020 08:36:13,02/11/2020 08:36:16,02/11/2020 11:41:01,02/11/2020 11:41:03,1274422,1282816,8394,184
6193,02/11/2020 11:40:58,02/11/2020 11:41:02,02/11/2020 13:50:24,02/11/2020 13:53:01,188470,195517,7047,132
6132,02/11/2020 18:39:59,02/11/2020 18:40:01,03/11/2020 00:20:27,03/11/2020 07:01:40,2009280,2026732,17452,741
6103,03/11/2020 05:09:19,03/11/2020 05:09:25,03/11/2020 07:03:05,03/11/2020 07:03:15,99344,105482,6138,113
6136,03/11/2020 02:02:33,03/11/2020 02:02:37,03/11/2020 08:39:38,03/11/2020 08:39:40,778677,802924,24247,397
6106,03/11/2020 09:47:32,03/11/2020 09:47:33,03/11/2020 13:13:39,03/11/2020 13:13:41,56474,62686,6212,206
6136,03/11/2020 13:50:08,03/11/2020 13:50:11,03/11/2020 17:42:41,03/11/2020 17:42:56,802937,816630,13693,232
6132,03/11/2020 18:43:56,03/11/2020 18:43:58,04/11/2020 02:18:58,04/11/2020 07:15:51,2026755,2051241,24486,751
6118,04/11/2020 08:01:15,04/11/2020 08:01:19,04/11/2020 08:31:43,04/11/2020 08:32:44,1282887,1284734,1847,31
6136,04/11/2020 00:11:59,04/11/2020 00:12:03,04/11/2020 08:45:54,04/11/2020 08:46:54,816647,848032,31385,514
6118,04/11/2020 09:20:28,04/11/2020 09:20:31,04/11/2020 09:20:47,04/11/2020 09:20:47,1284736,1284738,2,0
6118,04/11/2020 09:21:07,04/11/2020 09:21:11,04/11/2020 12:43:35,04/11/2020 14:34:15,1284738,1293109,8371,313
6133,03/11/2020 19:38:23,03/11/2020 19:38:25,04/11/2020 02:14:52,04/11/2020 10:06:56,198821,217722,18901,868
6193,04/11/2020 09:17:53,04/11/2020 09:17:57,04/11/2020 10:54:47,04/11/2020 12:22:20,195604,200737,5133,184
6132,04/11/2020 15:47:14,04/11/2020 15:47:15,04/11/2020 23:27:58,05/11/2020 07:11:35,2051258,2076014,24756,924
6184,04/11/2020 15:48:00,04/11/2020 15:48:01,04/11/2020 16:34:03,04/11/2020 16:34:05,45884,48482,2598,46
6131,04/11/2020 17:09:35,04/11/2020 17:09:37,04/11/2020 17:12:39,04/11/2020 17:12:41,0,42,42,3
6101,04/11/2020 16:33:39,04/11/2020 16:33:40,04/11/2020 17:47:39,04/11/2020 17:47:46,165927,170520,4593,74
6118,04/11/2020 18:15:09,04/11/2020 18:15:10,04/11/2020 22:10:47,04/11/2020 22:10:51,1293114,1308279,15165,235
6184,04/11/2020 22:41:25,04/11/2020 22:41:30,05/11/2020 08:20:29,05/11/2020 08:21:38,48497,74130,25633,580
6136,05/11/2020 08:28:43,05/11/2020 08:28:47,05/11/2020 10:40:55,05/11/2020 10:40:55,848087,856378,8291,132
6118,05/11/2020 08:37:58,05/11/2020 08:38:01,05/11/2020 11:09:37,05/11/2020 14:29:03,1308296,1313352,5056,351
6168,04/11/2020 18:55:45,04/11/2020 18:55:46,05/11/2020 03:45:54,05/11/2020 08:39:46,273513924,273542473,28549,824
6131,05/11/2020 08:55:33,05/11/2020 08:55:34,05/11/2020 08:56:47,05/11/2020 08:56:49,0,20,20,1
6167,05/11/2020 09:26:07,05/11/2020 09:26:08,05/11/2020 09:26:38,05/11/2020 09:26:41,0,0,0,0
6167,05/11/2020 09:31:04,05/11/2020 09:31:06,05/11/2020 09:34:07,05/11/2020 09:34:10,0,0,0,3
6197,05/11/2020 10:03:29,05/11/2020 10:03:30,05/11/2020 10:07:35,05/11/2020 10:07:38,0,66,66,4
6128,05/11/2020 10:39:07,05/11/2020 10:39:08,05/11/2020 10:40:57,05/11/2020 10:40:59,0,29,29,1
6191,05/11/2020 10:59:40,05/11/2020 10:59:42,05/11/2020 11:01:08,05/11/2020 11:01:10,0,23,23,1
6193,05/11/2020 09:23:06,05/11/2020 09:23:10,05/11/2020 11:32:53,05/11/2020 11:43:08,200780,207741,6961,140
6118,05/11/2020 18:08:38,05/11/2020 18:08:39,05/11/2020 21:08:19,05/11/2020 21:08:29,1313357,1324931,11574,179
6132,02/10/2020 23:06:10,02/10/2020 23:06:12,03/10/2020 07:55:48,03/10/2020 09:12:22,1297235,1327834,30599,606
6182,06/11/2020 00:00:11,06/11/2020 00:00:16,06/11/2020 01:34:34,06/11/2020 01:34:41,273027630,273032875,5245,94
6160,06/11/2020 10:54:59,06/11/2020 10:55:00,06/11/2020 10:56:24,06/11/2020 10:56:26,0,22,22,1
6167,06/11/2020 11:06:43,06/11/2020 11:06:45,06/11/2020 11:08:41,06/11/2020 11:08:43,0,32,32,2
6167,06/11/2020 11:30:28,06/11/2020 11:30:29,06/11/2020 11:32:07,06/11/2020 11:32:09,0,28,28,1
6151,06/11/2020 13:02:42,06/11/2020 13:02:48,06/11/2020 17:28:56,06/11/2020 17:58:53,101221229,101236000,14771,296
6143,06/11/2020 15:46:07,06/11/2020 15:46:11,06/11/2020 19:49:03,06/11/2020 19:49:03,675352,689887,14535,242
6132,06/11/2020 15:48:04,06/11/2020 15:48:06,07/11/2020 00:31:52,07/11/2020 10:26:44,2096262,2124747,28485,1118
6118,06/11/2020 16:36:27,06/11/2020 16:36:52,06/11/2020 20:05:33,06/11/2020 22:37:39,1324962,1332707,7745,361
6106,06/11/2020 09:42:30,06/11/2020 09:42:31,06/11/2020 16:54:17,06/11/2020 16:54:19,62869,69095,6226,431
6143,07/11/2020 09:57:44,07/11/2020 09:57:48,07/11/2020 15:41:58,07/11/2020 15:42:06,716989,737951,20962,344
6120,06/11/2020 21:42:00,06/11/2020 21:42:01,07/11/2020 11:11:09,07/11/2020 11:11:22,308226,357730,49504,809
6132,07/11/2020 15:00:45,07/11/2020 15:00:49,08/11/2020 04:37:39,08/11/2020 10:56:38,2124757,2172223,47466,1195
6175,08/11/2020 09:23:35,08/11/2020 09:23:39,08/11/2020 12:10:10,08/11/2020 12:11:13,274638214,274647532,9318,167
6155,08/11/2020 10:30:16,08/11/2020 10:30:17,08/11/2020 14:32:46,08/11/2020 14:32:48,271631386,271635906,4520,242
6104,08/11/2020 15:04:50,08/11/2020 15:04:50,08/11/2020 15:04:50,08/11/2020 15:05:41,81505,81505,0,0
6182,08/11/2020 15:11:25,08/11/2020 15:11:30,08/11/2020 17:28:30,08/11/2020 17:28:30,273033015,273040574,7559,137
6132,08/11/2020 20:12:11,08/11/2020 20:12:13,08/11/2020 20:12:14,08/11/2020 20:13:05,2172242,2172242,0,0
6132,08/11/2020 20:13:27,08/11/2020 20:13:28,08/11/2020 23:37:25,09/11/2020 06:16:41,2172242,2181791,9549,603
6146,08/11/2020 15:45:01,08/11/2020 15:45:05,08/11/2020 21:12:02,08/11/2020 22:17:40,124554,141900,17346,392
6118,09/11/2020 08:30:26,09/11/2020 08:30:29,09/11/2020 11:47:06,09/11/2020 13:12:35,1332801,1341351,8550,282
6168,09/11/2020 09:08:47,09/11/2020 09:08:49,09/11/2020 13:09:46,09/11/2020 13:09:46,273542670,273557055,14385,240
6193,09/11/2020 15:49:52,09/11/2020 15:49:57,09/11/2020 17:57:27,09/11/2020 17:57:32,207933,214917,6984,127
6132,09/11/2020 18:09:42,09/11/2020 18:09:44,09/11/2020 22:24:45,09/11/2020 22:24:47,2181814,2197198,15384,255
6118,09/11/2020 13:25:29,09/11/2020 13:25:30,09/11/2020 20:56:39,09/11/2020 21:31:49,1341351,1370581,29230,486
6120,09/11/2020 18:53:23,09/11/2020 18:53:28,09/11/2020 20:55:06,10/11/2020 06:44:17,357874,364627,6753,710
6155,09/11/2020 15:17:12,09/11/2020 15:17:13,10/11/2020 07:37:51,10/11/2020 12:50:37,271635980,271692776,56796,1293
6132,10/11/2020 15:48:02,10/11/2020 15:48:04,10/11/2020 23:15:12,11/11/2020 07:05:43,2197232,2221493,24261,917
6118,10/11/2020 16:08:22,10/11/2020 16:08:35,10/11/2020 19:12:58,10/11/2020 19:41:37,1370614,1378867,8253,213
6120,10/11/2020 19:04:04,10/11/2020 19:04:08,10/11/2020 21:08:29,11/11/2020 08:18:34,364659,371631,6972,794
6136,11/11/2020 11:46:33,11/11/2020 11:46:38,11/11/2020 16:22:48,11/11/2020 16:23:01,856693,873837,17144,276
6193,11/11/2020 09:16:36,11/11/2020 09:16:41,11/11/2020 11:25:38,11/11/2020 12:22:18,214997,222034,7037,185
6132,11/11/2020 15:47:53,11/11/2020 15:47:55,11/11/2020 21:48:42,12/11/2020 07:03:25,2221510,2240406,18896,915
6118,11/11/2020 16:11:06,11/11/2020 16:11:07,11/11/2020 19:23:19,11/11/2020 19:23:21,1378898,1384596,5698,192
6168,11/11/2020 19:06:48,11/11/2020 19:06:51,12/11/2020 00:44:16,12/11/2020 08:31:15,273557170,273574307,17137,804
6175,11/11/2020 20:27:45,11/11/2020 20:27:49,12/11/2020 02:58:29,12/11/2020 12:55:40,274647690,274666924,19234,987
6151,11/11/2020 17:24:18,11/11/2020 17:24:23,12/11/2020 07:50:15,12/11/2020 07:50:39,101236307,101287336,51029,866
6193,12/11/2020 09:09:59,12/11/2020 09:10:04,12/11/2020 09:52:25,12/11/2020 09:52:40,222076,224542,2466,42
6118,12/11/2020 11:36:51,12/11/2020 11:36:57,12/11/2020 16:36:56,12/11/2020 16:37:17,1384623,1402132,17509,300
6132,12/11/2020 17:19:21,12/11/2020 17:19:23,13/11/2020 00:19:18,13/11/2020 07:12:52,2240426,2262598,22172,833
6189,12/11/2020 15:31:54,12/11/2020 15:31:56,12/11/2020 23:35:57,13/11/2020 05:41:09,273379130,273403855,24725,849
6118,13/11/2020 08:39:49,13/11/2020 08:39:53,13/11/2020 14:02:08,13/11/2020 14:30:58,1402156,1410522,8366,351
6177,13/11/2020 10:38:01,13/11/2020 10:38:03,13/11/2020 12:53:39,13/11/2020 12:53:41,51087,58749,7662,135
6101,13/11/2020 09:02:28,13/11/2020 09:02:35,13/11/2020 13:41:35,13/11/2020 15:34:28,171047,185791,14744,392
6132,13/11/2020 16:00:09,13/11/2020 16:00:11,13/11/2020 21:42:51,14/11/2020 09:52:15,2262616,2279982,17366,1072
6189,13/11/2020 16:50:43,13/11/2020 16:50:46,14/11/2020 01:47:51,14/11/2020 07:28:56,273403877,273431711,27834,878
6184,13/11/2020 19:50:33,13/11/2020 19:50:34,14/11/2020 10:03:02,14/11/2020 10:03:04,74550,124120,49570,852
6144,14/11/2020 11:05:15,14/11/2020 11:05:20,14/11/2020 11:31:56,14/11/2020 11:32:03,131425,133025,1600,26
6133,14/11/2020 12:06:43,14/11/2020 12:06:47,14/11/2020 17:14:06,14/11/2020 17:14:23,218317,236421,18104,307
6132,14/11/2020 20:38:03,14/11/2020 20:38:06,15/11/2020 03:51:45,15/11/2020 14:20:55,2280004,2303644,23640,1062
6118,14/11/2020 23:53:03,14/11/2020 23:53:36,15/11/2020 00:06:03,15/11/2020 08:52:35,1410599,1411350,751,539
6136,15/11/2020 12:04:51,15/11/2020 12:04:56,15/11/2020 13:53:11,15/11/2020 13:54:12,874040,880475,6435,109
6118,15/11/2020 12:39:39,15/11/2020 12:39:42,15/11/2020 14:51:01,15/11/2020 14:51:57,1411359,1419433,8074,132
6188,15/11/2020 15:25:36,15/11/2020 15:25:38,15/11/2020 17:42:19,15/11/2020 17:42:21,274178139,274184946,6807,136
6155,15/11/2020 15:50:53,15/11/2020 15:50:54,15/11/2020 17:53:25,15/11/2020 17:53:27,271693145,271694926,1781,122
6119,15/11/2020 09:05:28,15/11/2020 09:05:29,15/11/2020 21:22:15,15/11/2020 21:30:35,604356,642029,37673,745
6184,15/11/2020 21:46:37,15/11/2020 21:46:40,15/11/2020 22:50:06,15/11/2020 22:51:04,124194,127957,3763,64
6151,15/11/2020 11:30:49,15/11/2020 11:30:50,15/11/2020 23:08:22,15/11/2020 23:08:27,101287485,101328423,40938,697
6184,15/11/2020 23:51:52,15/11/2020 23:51:56,16/11/2020 05:34:22,16/11/2020 08:25:30,127959,147813,19854,513
6189,15/11/2020 16:24:50,15/11/2020 16:24:52,16/11/2020 05:46:42,16/11/2020 05:47:31,273431771,273453797,22026,802
6118,15/11/2020 17:52:38,15/11/2020 17:52:39,16/11/2020 02:38:50,16/11/2020 06:47:35,1419438,1451656,32218,774
6120,15/11/2020 16:54:04,15/11/2020 16:54:09,15/11/2020 19:01:23,16/11/2020 07:12:14,371914,378976,7062,858
6193,16/11/2020 09:03:44,16/11/2020 09:04:02,16/11/2020 11:07:51,16/11/2020 12:01:49,224734,231519,6785,178
6147,16/11/2020 08:36:13,16/11/2020 08:36:17,16/11/2020 12:20:42,16/11/2020 12:57:04,99766,108386,8620,260
6115,14/11/2020 17:44:41,14/11/2020 17:44:42,15/11/2020 10:30:42,16/11/2020 15:04:57,303570,364275,60705,2720
6132,16/11/2020 15:56:16,16/11/2020 15:56:18,16/11/2020 21:55:06,17/11/2020 07:13:16,2303695,2322081,18386,917
6118,16/11/2020 12:31:36,16/11/2020 12:31:39,16/11/2020 15:58:50,16/11/2020 15:59:10,1451669,1463783,12114,207
6118,16/11/2020 17:58:35,16/11/2020 17:58:36,16/11/2020 20:37:50,16/11/2020 20:37:52,1463788,1470814,7026,159
6189,16/11/2020 16:44:16,16/11/2020 16:44:18,17/11/2020 05:38:22,17/11/2020 05:38:24,273453819,273478213,24394,774
6118,17/11/2020 09:06:42,17/11/2020 09:07:02,17/11/2020 12:20:37,17/11/2020 13:45:51,1470840,1479208,8368,279
6132,17/11/2020 15:43:55,17/11/2020 15:43:57,17/11/2020 22:20:17,18/11/2020 07:24:18,2322098,2343020,20922,940
6111,17/11/2020 09:52:21,17/11/2020 09:52:22,17/11/2020 16:21:28,17/11/2020 16:21:30,88402,94721,6319,389
6189,17/11/2020 15:57:00,17/11/2020 15:57:03,17/11/2020 19:04:24,17/11/2020 19:04:26,273478233,273488862,10629,187
6104,17/11/2020 13:58:39,17/11/2020 13:58:43,17/11/2020 20:04:47,17/11/2020 20:06:03,82151,92766,10615,367
6189,17/11/2020 19:19:07,17/11/2020 19:19:09,18/11/2020 00:06:47,18/11/2020 05:43:07,273488862,273502590,13728,624
6120,17/11/2020 20:30:50,17/11/2020 20:30:55,17/11/2020 22:33:49,18/11/2020 06:45:27,379078,385958,6880,614
6143,17/11/2020 15:52:42,17/11/2020 15:52:48,18/11/2020 11:03:28,18/11/2020 11:03:37,769672,806085,36413,1150
6132,18/11/2020 15:43:02,18/11/2020 15:43:04,18/11/2020 21:19:00,19/11/2020 07:15:22,2343037,2360324,17287,932
6143,18/11/2020 16:45:57,18/11/2020 16:46:00,18/11/2020 19:33:13,18/11/2020 19:33:13,806097,815955,9858,167
6155,18/11/2020 22:33:22,18/11/2020 22:33:26,19/11/2020 01:11:04,19/11/2020 01:11:29,271695156,271703665,8509,158
6189,18/11/2020 17:10:42,18/11/2020 17:10:44,19/11/2020 01:17:12,19/11/2020 06:32:22,273502612,273527625,25013,801
6118,19/11/2020 08:38:36,19/11/2020 08:38:39,19/11/2020 11:53:59,19/11/2020 12:24:46,1479292,1487488,8196,226
6193,19/11/2020 08:57:08,19/11/2020 08:57:12,19/11/2020 11:07:46,19/11/2020 11:18:34,231658,238759,7101,141
6132,19/11/2020 15:46:52,19/11/2020 15:46:54,19/11/2020 22:40:13,20/11/2020 07:12:53,2360341,2381760,21419,926
6127,19/11/2020 15:58:17,19/11/2020 15:58:20,19/11/2020 19:16:06,19/11/2020 19:16:09,154384,167013,12629,197
6111,19/11/2020 09:38:25,19/11/2020 09:38:27,19/11/2020 16:31:41,19/11/2020 16:31:43,94818,101053,6235,413
6189,19/11/2020 15:19:36,19/11/2020 15:19:38,19/11/2020 17:07:41,19/11/2020 17:07:43,273527643,273533748,6105,108
6175,19/11/2020 17:56:01,19/11/2020 17:56:06,20/11/2020 00:40:53,20/11/2020 10:28:00,274667264,274687044,19780,991
6104,19/11/2020 12:35:01,19/11/2020 12:35:05,19/11/2020 18:38:00,19/11/2020 18:39:28,92888,103374,10486,364
6189,19/11/2020 17:29:00,19/11/2020 17:29:02,20/11/2020 05:02:07,20/11/2020 05:02:09,273533749,273546274,12525,693
6120,19/11/2020 20:17:07,19/11/2020 20:17:10,19/11/2020 22:19:25,20/11/2020 06:45:43,386052,392828,6776,628
6118,20/11/2020 09:52:22,20/11/2020 09:52:25,20/11/2020 14:01:25,20/11/2020 14:35:05,1487516,1496127,8611,282
6193,20/11/2020 09:05:33,20/11/2020 09:05:38,20/11/2020 11:10:28,20/11/2020 12:25:52,238803,245523,6720,200
6132,20/11/2020 15:40:26,20/11/2020 15:40:28,20/11/2020 22:28:33,21/11/2020 08:02:20,2381776,2403255,21479,981
6155,20/11/2020 14:45:19,20/11/2020 14:45:20,20/11/2020 17:57:31,20/11/2020 17:57:34,271703778,271707231,3453,192
6118,20/11/2020 20:54:31,20/11/2020 20:54:32,21/11/2020 06:16:02,21/11/2020 07:10:09,1496134,1530829,34695,615
6136,20/11/2020 18:39:44,20/11/2020 18:39:45,21/11/2020 08:06:19,21/11/2020 08:06:21,880755,914113,33358,806
6189,20/11/2020 17:56:11,20/11/2020 17:56:13,21/11/2020 08:34:44,21/11/2020 08:34:56,273546300,273569516,23216,878
6189,20/11/2020 17:56:11,20/11/2020 17:56:13,21/11/2020 08:34:44,21/11/2020 08:34:56,273546300,273569516,23216,878
6189,20/11/2020 17:56:11,20/11/2020 17:56:13,21/11/2020 08:34:44,21/11/2020 08:34:56,273546300,273569516,23216,878
6136,21/11/2020 11:22:18,21/11/2020 11:22:21,21/11/2020 17:06:33,21/11/2020 17:06:35,914121,935295,21174,344
6116,21/11/2020 10:52:38,21/11/2020 10:52:39,21/11/2020 12:59:50,21/11/2020 13:00:12,347644,355623,7979,127
6139,21/11/2020 13:26:13,21/11/2020 13:26:39,21/11/2020 16:52:32,21/11/2020 16:53:03,240943,253722,12779,206
6193,21/11/2020 11:46:51,21/11/2020 11:46:55,21/11/2020 13:53:10,21/11/2020 14:41:26,245570,252469,6899,174
6169,22/11/2020 12:58:59,22/11/2020 12:59:01,22/11/2020 14:53:57,22/11/2020 14:57:55,273220889,273224085,3196,118
6133,21/11/2020 14:19:48,21/11/2020 14:19:49,22/11/2020 02:54:14,22/11/2020 13:37:47,236833,280668,43835,1397
6120,22/11/2020 10:04:27,22/11/2020 10:04:33,22/11/2020 12:09:57,22/11/2020 15:03:40,392954,399811,6857,299
6120,22/11/2020 15:42:38,22/11/2020 15:42:42,22/11/2020 19:55:33,22/11/2020 19:56:32,399813,415880,16067,253
6100,22/11/2020 17:47:30,22/11/2020 17:47:33,22/11/2020 20:43:40,22/11/2020 20:43:43,307530,315938,8408,176
6132,21/11/2020 13:33:08,21/11/2020 13:33:13,22/11/2020 02:36:32,22/11/2020 21:32:04,2403266,2448634,45368,1918
6189,22/11/2020 16:42:50,22/11/2020 16:42:52,23/11/2020 05:29:16,23/11/2020 05:29:18,273569578,273586321,16743,766
6184,22/11/2020 15:32:08,22/11/2020 15:32:09,23/11/2020 07:45:31,23/11/2020 07:45:33,148127,183960,35833,973
6193,23/11/2020 09:07:37,23/11/2020 09:07:40,23/11/2020 11:17:37,23/11/2020 12:40:32,252555,259610,7055,212
6143,23/11/2020 10:07:33,23/11/2020 10:07:34,23/11/2020 13:00:37,23/11/2020 13:00:39,816190,825837,9647,173
6147,23/11/2020 10:49:58,23/11/2020 10:50:01,23/11/2020 14:19:52,23/11/2020 14:32:19,108848,117351,8503,222
6147,23/11/2020 10:49:58,23/11/2020 10:50:01,23/11/2020 14:19:52,23/11/2020 14:32:19,108848,117351,8503,222
6147,23/11/2020 10:49:58,23/11/2020 10:50:01,23/11/2020 14:19:52,23/11/2020 14:32:19,108848,117351,8503,222
6147,23/11/2020 10:49:58,23/11/2020 10:50:01,23/11/2020 14:19:52,23/11/2020 14:32:19,108848,117351,8503,222
6147,23/11/2020 10:49:58,23/11/2020 10:50:01,23/11/2020 14:19:52,23/11/2020 14:32:19,108848,117351,8503,222
6139,23/11/2020 15:39:20,23/11/2020 15:39:34,23/11/2020 17:32:46,23/11/2020 17:38:00,253859,260800,6941,118
6132,23/11/2020 15:40:40,23/11/2020 15:40:42,23/11/2020 20:32:56,24/11/2020 07:00:27,2448670,2462727,14057,919
6189,23/11/2020 17:14:05,23/11/2020 17:14:07,24/11/2020 05:24:22,24/11/2020 05:24:24,273586345,273611031,24686,730
6120,23/11/2020 21:15:19,23/11/2020 21:15:23,23/11/2020 23:22:40,24/11/2020 07:33:41,415944,423011,7067,618
6193,24/11/2020 09:10:23,24/11/2020 09:10:27,24/11/2020 09:39:38,24/11/2020 09:40:04,259651,261355,1704,29
6147,24/11/2020 08:31:47,24/11/2020 08:31:50,24/11/2020 11:48:15,24/11/2020 12:18:39,117401,124405,7004,226
6104,24/11/2020 10:57:29,24/11/2020 10:57:32,24/11/2020 14:52:43,24/11/2020 14:55:22,103712,110478,6766,237
6118,24/11/2020 08:54:44,24/11/2020 08:54:52,24/11/2020 15:44:24,24/11/2020 15:44:36,1530928,1554542,23614,409
6132,24/11/2020 15:44:31,24/11/2020 15:44:33,24/11/2020 23:02:03,25/11/2020 07:10:35,2462744,2485813,23069,926
6115,24/11/2020 14:37:44,24/11/2020 14:37:46,24/11/2020 16:41:21,24/11/2020 16:41:35,364670,372446,7776,123
6189,24/11/2020 16:39:30,24/11/2020 16:39:33,24/11/2020 16:51:20,24/11/2020 16:51:22,273611053,273611718,665,11
6153,24/11/2020 16:54:33,24/11/2020 16:54:36,24/11/2020 21:13:04,24/11/2020 21:25:02,282593883,282604569,10686,270
6118,24/11/2020 22:59:35,24/11/2020 22:59:39,24/11/2020 23:28:06,24/11/2020 23:28:14,1554553,1556302,1749,28
6189,24/11/2020 17:16:51,24/11/2020 17:16:53,25/11/2020 05:28:25,25/11/2020 05:28:27,273611719,273638224,26505,731
6120,24/11/2020 19:57:22,24/11/2020 19:57:25,24/11/2020 20:52:58,25/11/2020 07:33:57,423049,425846,2797,696
6190,25/11/2020 10:48:13,25/11/2020 10:48:14,25/11/2020 10:51:04,25/11/2020 10:51:06,0,48,48,2
6190,25/11/2020 11:21:43,25/11/2020 11:21:44,25/11/2020 11:22:58,25/11/2020 11:23:00,0,21,21,1
6154,25/11/2020 11:43:59,25/11/2020 11:44:00,25/11/2020 11:49:23,25/11/2020 11:49:27,0,89,89,5
6154,25/11/2020 12:06:23,25/11/2020 12:06:24,25/11/2020 12:09:14,25/11/2020 12:09:16,65,113,48,2
6132,25/11/2020 15:49:02,25/11/2020 15:49:03,25/11/2020 23:09:24,26/11/2020 07:13:42,2485830,2509159,23329,924
6136,25/11/2020 15:55:19,25/11/2020 15:55:24,25/11/2020 20:48:26,25/11/2020 20:49:04,935512,953749,18237,293
6189,25/11/2020 16:01:33,25/11/2020 16:01:36,25/11/2020 16:18:02,25/11/2020 16:18:04,273638245,273639170,925,16
6189,25/11/2020 16:45:13,25/11/2020 16:45:15,26/11/2020 05:30:19,26/11/2020 05:30:21,273639170,273673373,34203,765
6118,26/11/2020 11:53:46,26/11/2020 11:53:49,26/11/2020 14:33:29,26/11/2020 14:33:31,1556372,1564274,7902,159
6118,26/11/2020 11:53:46,26/11/2020 11:53:49,26/11/2020 14:33:29,26/11/2020 14:33:31,1556372,1564274,7902,159
6118,26/11/2020 11:53:46,26/11/2020 11:53:49,26/11/2020 14:33:29,26/11/2020 14:33:31,1556372,1564274,7902,159
6155,26/11/2020 14:27:35,26/11/2020 14:27:36,26/11/2020 14:27:41,26/11/2020 14:37:13,271707652,271707653,1,9
6155,26/11/2020 14:38:11,26/11/2020 14:38:12,26/11/2020 14:38:16,26/11/2020 14:39:44,271707653,271707653,0,1
6155,26/11/2020 14:40:32,26/11/2020 14:40:33,26/11/2020 14:40:36,26/11/2020 14:42:21,271707653,271707653,0,1
6132,26/11/2020 15:42:51,26/11/2020 15:42:53,26/11/2020 21:25:45,27/11/2020 07:09:22,2509176,2526398,17222,926
6168,26/11/2020 20:35:53,26/11/2020 20:35:55,27/11/2020 02:07:47,27/11/2020 08:48:55,273575039,273592059,17020,733
6189,26/11/2020 17:04:30,26/11/2020 17:04:32,27/11/2020 06:32:05,27/11/2020 06:32:07,273673396,273704037,30641,807
6118,26/11/2020 20:24:30,26/11/2020 20:24:31,27/11/2020 07:26:32,27/11/2020 07:26:38,1564287,1593845,29558,662
6155,26/11/2020 14:42:56,26/11/2020 14:42:57,27/11/2020 03:51:13,27/11/2020 10:06:41,271707653,271752025,44372,1163
6132,27/11/2020 15:43:02,27/11/2020 15:43:02,27/11/2020 23:31:00,28/11/2020 07:44:21,2526416,2551053,24637,961
6143,27/11/2020 15:52:01,27/11/2020 15:52:06,27/11/2020 19:41:42,27/11/2020 19:41:44,826046,839200,13154,229
6104,27/11/2020 12:47:34,27/11/2020 12:47:39,27/11/2020 19:00:13,27/11/2020 19:36:00,110688,121388,10700,408
6155,27/11/2020 17:24:58,27/11/2020 17:24:59,27/11/2020 20:17:25,27/11/2020 20:17:27,271752047,271754881,2834,172
6189,27/11/2020 15:34:00,27/11/2020 15:34:02,28/11/2020 01:56:19,28/11/2020 07:48:43,273704055,273736324,32269,974
6118,28/11/2020 13:52:50,28/11/2020 13:52:54,28/11/2020 16:44:32,28/11/2020 16:44:37,1593886,1602473,8587,171
6136,28/11/2020 14:23:55,28/11/2020 14:23:58,28/11/2020 16:51:42,28/11/2020 16:51:44,953902,962448,8546,147
6132,28/11/2020 18:55:59,28/11/2020 18:56:00,29/11/2020 03:26:13,29/11/2020 07:46:36,2551075,2578720,27645,770
6119,28/11/2020 14:21:22,28/11/2020 14:21:24,28/11/2020 21:47:29,28/11/2020 21:47:31,642836,665656,22820,446
6120,28/11/2020 23:28:07,28/11/2020 23:28:12,29/11/2020 01:33:41,29/11/2020 08:24:57,426066,432973,6907,536
6143,29/11/2020 11:52:27,29/11/2020 11:52:31,29/11/2020 20:18:20,29/11/2020 20:18:23,866920,896773,29853,505
6116,29/11/2020 11:26:49,29/11/2020 11:26:51,29/11/2020 14:52:32,29/11/2020 15:32:39,356006,368847,12841,245
6136,29/11/2020 12:07:46,29/11/2020 12:07:48,29/11/2020 17:03:45,29/11/2020 17:04:27,962491,979590,17099,296
6153,29/11/2020 11:20:58,29/11/2020 11:22:40,29/11/2020 18:45:21,29/11/2020 19:18:45,282604792,282630908,26116,477
6151,28/11/2020 19:41:17,28/11/2020 19:41:18,29/11/2020 19:38:49,29/11/2020 19:38:51,101329101,101410436,81335,1437
6132,29/11/2020 20:31:11,29/11/2020 20:31:12,30/11/2020 00:22:05,30/11/2020 07:26:44,2578746,2590111,11365,655
6189,29/11/2020 16:28:37,29/11/2020 16:28:40,30/11/2020 05:30:43,30/11/2020 05:30:45,273736385,273757422,21037,782
6136,29/11/2020 18:12:50,29/11/2020 18:12:55,30/11/2020 03:34:00,30/11/2020 07:24:31,979593,1013808,34215,791
6143,30/11/2020 08:24:08,30/11/2020 08:24:15,30/11/2020 10:59:50,30/11/2020 10:59:58,896799,906524,9725,155
6147,30/11/2020 08:35:47,30/11/2020 08:36:05,30/11/2020 12:03:00,30/11/2020 12:59:01,124795,133186,8391,263
6136,30/11/2020 12:47:11,30/11/2020 12:47:16,30/11/2020 15:05:50,30/11/2020 15:05:59,1013821,1022466,8645,138
6132,30/11/2020 15:41:44,30/11/2020 15:41:46,30/11/2020 21:43:32,01/12/2020 06:50:10,2590128,2608660,18532,908
6189,30/11/2020 15:41:56,30/11/2020 15:41:58,01/12/2020 05:31:13,01/12/2020 05:31:15,273757442,273787725,30283,829
6144,30/11/2020 20:44:02,30/11/2020 20:44:06,01/12/2020 02:52:19,01/12/2020 07:24:42,134232,153521,19289,640
6184,30/11/2020 17:13:00,30/11/2020 17:13:01,01/12/2020 07:48:30,01/12/2020 07:48:32,184328,235200,50872,875
6155,30/11/2020 18:36:34,30/11/2020 18:36:37,01/12/2020 06:01:48,01/12/2020 07:50:28,271755092,271792246,37154,793
6118,01/12/2020 09:35:32,01/12/2020 09:35:40,01/12/2020 13:32:34,01/12/2020 13:33:21,1602595,1616403,13808,237
6136,30/11/2020 15:56:59,30/11/2020 15:57:05,30/11/2020 22:30:42,01/12/2020 14:50:49,1022469,1045882,23413,1373
6132,01/12/2020 15:46:19,01/12/2020 15:46:22,01/12/2020 22:29:54,02/12/2020 07:09:26,2608678,2629634,20956,923
6136,01/12/2020 15:51:41,01/12/2020 15:51:45,01/12/2020 19:52:07,01/12/2020 19:52:13,1045885,1060776,14891,240
6189,01/12/2020 16:29:40,01/12/2020 16:29:42,02/12/2020 05:31:54,02/12/2020 05:31:56,273787747,273820415,32668,782
6155,01/12/2020 18:27:02,01/12/2020 18:27:03,02/12/2020 08:27:16,02/12/2020 08:28:08,271792277,271792357,80,841
6147,02/12/2020 08:24:24,02/12/2020 08:24:39,02/12/2020 11:11:59,02/12/2020 12:58:31,133307,138993,5686,274
6168,02/12/2020 13:29:09,02/12/2020 13:29:11,02/12/2020 19:16:29,02/12/2020 19:16:29,273592327,273611984,19657,347
6132,02/12/2020 15:41:30,02/12/2020 15:41:32,02/12/2020 23:15:34,03/12/2020 07:33:02,2629651,2653795,24144,951
6169,02/12/2020 13:35:37,02/12/2020 13:35:39,02/12/2020 17:18:17,02/12/2020 18:00:24,273224592,273236824,12232,264
6147,02/12/2020 19:00:58,02/12/2020 19:01:01,02/12/2020 22:41:30,02/12/2020 23:03:00,139010,149330,10320,242
6189,02/12/2020 16:51:24,02/12/2020 16:51:26,03/12/2020 05:30:24,03/12/2020 05:30:26,273820437,273849693,29256,759
6118,02/12/2020 17:52:13,02/12/2020 17:52:14,03/12/2020 04:58:23,03/12/2020 07:26:03,1616465,1657693,41228,813
6168,03/12/2020 14:41:45,03/12/2020 14:41:48,03/12/2020 18:44:21,03/12/2020 18:44:56,273612028,273623158,11130,243
6132,03/12/2020 15:46:56,03/12/2020 15:46:58,03/12/2020 23:15:55,04/12/2020 07:52:25,2653811,2677711,23900,965
6175,03/12/2020 19:49:47,03/12/2020 19:49:53,03/12/2020 19:49:54,03/12/2020 19:50:29,274687684,274687684,0,0
6175,03/12/2020 19:50:36,03/12/2020 19:50:41,04/12/2020 02:32:01,04/12/2020 09:57:10,274687684,274707138,19454,846
6150,03/12/2020 17:24:14,03/12/2020 17:24:16,03/12/2020 20:56:50,03/12/2020 20:58:08,20881,34007,13126,213
6118,03/12/2020 15:34:22,03/12/2020 15:34:29,03/12/2020 18:45:36,03/12/2020 23:17:15,1657704,1665876,8172,462
6118,03/12/2020 15:34:22,03/12/2020 15:34:29,03/12/2020 18:45:36,03/12/2020 23:17:15,1657704,1665876,8172,462
6189,03/12/2020 15:27:33,03/12/2020 15:27:34,04/12/2020 05:32:44,04/12/2020 05:32:46,273849713,273882382,32669,845
6150,03/12/2020 22:45:44,03/12/2020 22:45:46,04/12/2020 03:38:38,04/12/2020 11:06:32,34012,47796,13784,740
6118,04/12/2020 09:29:30,04/12/2020 09:29:39,04/12/2020 11:56:36,04/12/2020 11:56:53,1665894,1674377,8483,147
6118,04/12/2020 09:29:30,04/12/2020 09:29:39,04/12/2020 11:56:36,04/12/2020 11:56:53,1665894,1674377,8483,147
6118,04/12/2020 09:29:30,04/12/2020 09:29:39,04/12/2020 11:56:36,04/12/2020 11:56:53,1665894,1674377,8483,147
6137,04/12/2020 11:25:23,04/12/2020 11:25:24,04/12/2020 12:32:43,04/12/2020 12:32:57,89613,93997,4384,67
6118,04/12/2020 13:07:37,04/12/2020 13:07:37,04/12/2020 13:07:37,04/12/2020 13:09:17,1674379,1674379,0,1
6118,04/12/2020 13:09:30,04/12/2020 13:09:30,04/12/2020 13:09:30,04/12/2020 13:10:04,1674379,1674379,0,0
6118,04/12/2020 13:10:28,04/12/2020 13:10:28,04/12/2020 13:10:28,04/12/2020 13:10:58,1674379,1674379,0,0
6193,04/12/2020 09:21:56,04/12/2020 09:21:59,04/12/2020 11:36:50,04/12/2020 13:12:10,261836,268922,7086,230
6132,04/12/2020 15:47:49,04/12/2020 15:47:51,04/12/2020 22:43:31,05/12/2020 10:46:18,2677727,2699464,21737,1138
6136,04/12/2020 17:15:25,04/12/2020 17:15:31,04/12/2020 20:16:44,04/12/2020 20:16:44,1060931,1071883,10952,181
6144,04/12/2020 18:03:14,04/12/2020 18:03:18,04/12/2020 20:30:47,04/12/2020 20:30:51,153758,162718,8960,147
6174,04/12/2020 15:05:53,04/12/2020 15:05:56,04/12/2020 21:29:47,04/12/2020 22:00:42,273011673,273032596,20923,414
6118,04/12/2020 16:35:43,04/12/2020 16:35:47,04/12/2020 22:17:22,04/12/2020 22:18:04,1674384,1694277,19893,342
6121,04/12/2020 22:31:38,04/12/2020 22:31:42,05/12/2020 00:08:39,05/12/2020 00:08:43,59886,65827,5941,97
6189,04/12/2020 15:36:35,04/12/2020 15:36:37,05/12/2020 09:47:26,05/12/2020 09:47:28,273882402,273912404,30002,1090
6120,04/12/2020 22:08:41,04/12/2020 22:08:46,05/12/2020 08:32:43,05/12/2020 10:53:01,433314,472193,38879,764
6136,05/12/2020 11:34:58,05/12/2020 11:35:02,05/12/2020 21:41:34,05/12/2020 23:57:40,1071918,1108602,36684,742
6168,05/12/2020 12:13:47,05/12/2020 12:13:49,05/12/2020 18:30:19,05/12/2020 18:31:03,273623257,273642206,18949,377
6116,05/12/2020 10:34:30,05/12/2020 10:34:32,05/12/2020 14:01:01,05/12/2020 15:21:00,369126,382122,12996,286
6147,05/12/2020 15:37:32,05/12/2020 15:37:36,05/12/2020 17:42:20,05/12/2020 17:42:25,149510,155386,5876,124
6100,05/12/2020 15:46:57,05/12/2020 15:47:00,05/12/2020 19:14:37,05/12/2020 19:14:41,316663,325568,8905,207
6118,05/12/2020 15:35:20,05/12/2020 15:35:49,05/12/2020 18:40:29,05/12/2020 21:11:19,1694315,1701188,6873,335
6133,05/12/2020 16:22:12,05/12/2020 16:22:16,06/12/2020 03:49:13,06/12/2020 06:37:32,281494,316649,35155,855
6118,05/12/2020 23:32:46,05/12/2020 23:32:51,06/12/2020 02:41:45,06/12/2020 10:19:16,1701193,1709735,8542,646
6182,06/12/2020 10:08:37,06/12/2020 10:10:14,06/12/2020 11:12:54,06/12/2020 11:13:08,273042027,273045583,3556,64
6132,05/12/2020 14:31:32,05/12/2020 14:31:38,06/12/2020 12:58:38,06/12/2020 12:58:43,2699471,2737125,37654,1347
6118,06/12/2020 11:54:36,06/12/2020 11:54:40,06/12/2020 13:58:30,06/12/2020 13:58:40,1709739,1715385,5646,124
6188,06/12/2020 14:37:59,06/12/2020 14:38:00,07/12/2020 00:48:42,07/12/2020 09:30:15,274186073,274220721,34648,1132
6155,06/12/2020 12:53:10,06/12/2020 12:53:11,06/12/2020 16:47:19,06/12/2020 16:48:07,271792658,271792681,23,234
6120,06/12/2020 18:38:04,06/12/2020 18:38:16,07/12/2020 10:11:22,07/12/2020 10:11:27,472276,488820,16544,933
6143,06/12/2020 12:24:37,06/12/2020 12:24:42,06/12/2020 19:41:13,06/12/2020 19:41:24,906832,932632,25800,436
6178,06/12/2020 12:08:34,06/12/2020 12:08:57,06/12/2020 18:57:49,06/12/2020 19:54:49,286553195,286573157,19962,466
6189,06/12/2020 16:23:51,06/12/2020 16:23:53,07/12/2020 05:28:58,07/12/2020 05:29:00,273912465,273931336,18871,785
6118,06/12/2020 19:13:47,06/12/2020 19:13:56,07/12/2020 00:06:02,07/12/2020 07:21:07,1715398,1732430,17032,727
6147,07/12/2020 08:39:55,07/12/2020 08:39:58,07/12/2020 12:17:14,07/12/2020 12:17:16,155496,163876,8380,217
6155,06/12/2020 16:48:48,06/12/2020 16:48:49,07/12/2020 13:36:50,07/12/2020 13:47:41,271792681,271792800,119,1258
6155,07/12/2020 13:48:29,07/12/2020 13:48:30,07/12/2020 13:48:33,07/12/2020 13:50:06,271792800,271792800,0,1
6116,07/12/2020 09:52:16,07/12/2020 09:52:18,07/12/2020 11:55:05,07/12/2020 14:23:20,382207,389865,7658,271
6132,07/12/2020 15:45:40,07/12/2020 15:45:42,07/12/2020 22:40:34,08/12/2020 07:38:59,2737179,2758497,21318,953
6150,07/12/2020 19:59:09,07/12/2020 19:59:15,08/12/2020 08:03:19,08/12/2020 08:03:39,47964,82621,34657,724
6168,07/12/2020 20:41:20,07/12/2020 20:41:22,08/12/2020 00:31:57,08/12/2020 00:31:57,273642418,273653887,11469,230
6118,07/12/2020 13:41:52,07/12/2020 13:42:28,07/12/2020 22:09:07,07/12/2020 22:09:16,1732446,1761969,29523,507
6168,07/12/2020 20:41:20,07/12/2020 20:41:22,08/12/2020 00:31:57,08/12/2020 00:31:57,273642418,273653887,11469,230
6168,07/12/2020 20:41:20,07/12/2020 20:41:22,08/12/2020 00:31:57,08/12/2020 00:31:57,273642418,273653887,11469,230
6189,07/12/2020 15:33:36,07/12/2020 15:33:38,08/12/2020 05:34:26,08/12/2020 05:34:28,273931356,273963800,32444,840
6182,07/12/2020 19:27:29,07/12/2020 19:27:33,08/12/2020 00:45:18,08/12/2020 06:43:34,273045657,273060434,14777,676
6155,07/12/2020 13:50:37,07/12/2020 13:50:37,08/12/2020 15:38:30,08/12/2020 15:40:52,271792800,271792947,147,1550
6132,08/12/2020 15:42:33,08/12/2020 15:42:36,08/12/2020 23:20:39,09/12/2020 07:06:39,2758513,2782596,24083,924
6189,08/12/2020 15:23:16,08/12/2020 15:23:18,08/12/2020 16:27:02,08/12/2020 16:27:04,273963820,273967364,3544,63
6143,08/12/2020 10:35:17,08/12/2020 10:35:19,08/12/2020 16:28:54,08/12/2020 16:29:37,932717,952591,19874,354
6147,08/12/2020 15:19:05,08/12/2020 15:19:09,08/12/2020 18:59:05,08/12/2020 20:57:38,163952,172202,8250,338
6168,08/12/2020 21:00:57,08/12/2020 21:00:59,08/12/2020 22:04:57,08/12/2020 22:04:57,273653960,273657772,3812,64
6175,08/12/2020 21:06:51,08/12/2020 21:06:56,09/12/2020 03:58:41,09/12/2020 11:08:24,274707352,274726823,19471,841
6155,08/12/2020 17:52:01,08/12/2020 17:52:02,08/12/2020 21:34:13,08/12/2020 21:34:15,271792954,271797172,4218,222
6169,08/12/2020 14:03:59,08/12/2020 14:04:43,08/12/2020 20:45:07,08/12/2020 22:19:52,273237118,273259668,22550,495
6168,08/12/2020 22:41:43,08/12/2020 22:41:45,09/12/2020 03:37:23,09/12/2020 08:31:10,273657775,273671841,14066,589
6104,08/12/2020 20:41:32,08/12/2020 20:41:36,08/12/2020 23:09:07,08/12/2020 23:09:11,122188,131264,9076,147
6189,08/12/2020 17:04:07,08/12/2020 17:04:09,09/12/2020 05:24:06,09/12/2020 05:24:08,273967365,274004520,37155,740
6118,08/12/2020 20:56:41,08/12/2020 20:56:41,09/12/2020 07:10:00,09/12/2020 07:21:42,1762003,1799907,37904,625
6147,08/12/2020 23:02:10,08/12/2020 23:02:15,09/12/2020 04:39:02,09/12/2020 08:18:32,172208,189650,17442,556
6168,08/12/2020 22:41:43,08/12/2020 22:41:45,09/12/2020 03:37:23,09/12/2020 08:31:10,273657775,273671841,14066,589
6151,08/12/2020 20:26:53,08/12/2020 20:26:54,09/12/2020 08:33:20,09/12/2020 08:33:26,101410932,101453626,42694,726
6193,09/12/2020 09:15:34,09/12/2020 09:15:37,09/12/2020 11:29:50,09/12/2020 11:52:59,269157,276282,7125,157
6118,09/12/2020 11:14:32,09/12/2020 11:14:35,09/12/2020 13:44:11,09/12/2020 13:51:25,1799916,1808178,8262,156
6132,09/12/2020 15:43:48,09/12/2020 15:43:50,09/12/2020 23:43:40,10/12/2020 07:22:08,2782614,2808375,25761,938
6120,09/12/2020 19:57:17,09/12/2020 19:57:22,09/12/2020 22:24:51,09/12/2020 22:25:15,488964,493271,4307,147
6189,09/12/2020 16:29:38,09/12/2020 16:29:40,10/12/2020 05:31:24,10/12/2020 05:31:26,274004542,274038806,34264,781
6182,09/12/2020 19:17:01,09/12/2020 19:17:06,09/12/2020 23:20:06,10/12/2020 06:37:45,273060516,273070999,10483,680
6118,09/12/2020 20:13:59,09/12/2020 20:14:01,10/12/2020 00:06:03,10/12/2020 07:59:03,1808187,1821758,13571,705
6118,09/12/2020 20:13:59,09/12/2020 20:14:01,10/12/2020 00:06:03,10/12/2020 07:59:03,1808187,1821758,13571,705
6118,09/12/2020 20:13:59,09/12/2020 20:14:01,10/12/2020 00:06:03,10/12/2020 07:59:03,1808187,1821758,13571,705
6118,09/12/2020 20:13:59,09/12/2020 20:14:01,10/12/2020 00:06:03,10/12/2020 07:59:03,1808187,1821758,13571,705
6118,09/12/2020 20:13:59,09/12/2020 20:14:01,10/12/2020 00:06:03,10/12/2020 07:59:03,1808187,1821758,13571,705
6168,10/12/2020 09:47:30,10/12/2020 09:47:31,10/12/2020 15:38:02,10/12/2020 15:38:02,273671897,273692828,20931,350
6143,10/12/2020 09:57:51,10/12/2020 09:57:57,10/12/2020 11:06:51,10/12/2020 11:07:00,952678,956799,4121,69
6132,10/12/2020 15:48:34,10/12/2020 15:48:36,11/12/2020 01:37:07,11/12/2020 07:21:36,2808391,2841102,32711,933
6143,10/12/2020 16:25:43,10/12/2020 16:25:47,10/12/2020 19:51:02,10/12/2020 19:51:45,956811,968918,12107,206
6136,10/12/2020 11:36:09,10/12/2020 11:36:11,10/12/2020 16:27:53,10/12/2020 16:29:36,1108845,1125246,16401,293
6118,10/12/2020 17:11:19,10/12/2020 17:11:21,10/12/2020 19:57:25,10/12/2020 20:35:01,1821777,1828632,6855,203
6189,10/12/2020 16:32:17,10/12/2020 16:32:19,11/12/2020 08:01:43,11/12/2020 08:01:45,274038827,274072131,33304,929
6133,09/12/2020 19:52:06,09/12/2020 19:52:07,10/12/2020 03:57:39,11/12/2020 08:10:24,316867,345091,28224,2178
6151,10/12/2020 20:21:36,10/12/2020 20:21:37,11/12/2020 08:13:18,11/12/2020 08:13:21,101453728,101495577,41849,711
6151,11/12/2020 11:00:36,11/12/2020 11:00:42,11/12/2020 15:19:19,11/12/2020 16:09:24,101495582,101509841,14259,308
6132,11/12/2020 15:51:09,11/12/2020 15:51:11,11/12/2020 23:49:31,12/12/2020 10:50:22,2841119,2867219,26100,1139
6169,11/12/2020 12:21:19,11/12/2020 12:21:59,11/12/2020 19:25:26,11/12/2020 20:13:30,273259795,273284717,24922,472
6182,11/12/2020 18:48:46,11/12/2020 18:48:51,12/12/2020 00:06:29,12/12/2020 07:50:19,273071080,273086598,15518,781
6189,11/12/2020 18:08:33,11/12/2020 18:08:34,11/12/2020 23:06:53,12/12/2020 09:25:02,274072151,274086642,14491,916
6136,12/12/2020 09:35:17,12/12/2020 09:35:22,12/12/2020 18:59:33,12/12/2020 19:43:53,1125339,1159413,34074,608
6143,11/12/2020 12:57:23,11/12/2020 12:57:29,12/12/2020 00:15:42,12/12/2020 09:55:55,968954,1008554,39600,1258
6121,11/12/2020 19:24:31,11/12/2020 19:24:37,12/12/2020 11:08:36,12/12/2020 11:08:44,66318,112262,45944,944
6121,12/12/2020 11:50:34,12/12/2020 11:50:42,12/12/2020 12:49:16,12/12/2020 12:49:22,112264,115502,3238,58
6127,12/12/2020 15:42:20,12/12/2020 15:42:52,12/12/2020 20:01:39,12/12/2020 20:01:48,168139,184757,16618,259
6133,12/12/2020 18:04:00,12/12/2020 18:04:02,12/12/2020 18:36:41,12/12/2020 18:36:41,345176,346979,1803,32
6147,12/12/2020 16:22:25,12/12/2020 16:22:30,12/12/2020 18:45:11,12/12/2020 18:45:23,189869,198645,8776,142
6184,12/12/2020 20:14:17,12/12/2020 20:14:22,13/12/2020 04:38:07,13/12/2020 09:53:33,235775,265034,29259,819
6132,12/12/2020 21:24:24,12/12/2020 21:24:26,13/12/2020 05:29:36,13/12/2020 13:59:10,2867241,2893702,26461,994
6118,13/12/2020 10:10:59,13/12/2020 10:11:01,13/12/2020 11:43:42,13/12/2020 11:46:30,1828769,1834224,5455,95
6147,13/12/2020 11:04:30,13/12/2020 11:04:34,13/12/2020 13:43:59,13/12/2020 13:44:10,198692,207622,8930,159
6139,13/12/2020 15:50:39,13/12/2020 15:50:41,13/12/2020 17:46:39,13/12/2020 17:46:39,262189,269335,7146,116
6132,13/12/2020 14:13:16,13/12/2020 14:13:18,13/12/2020 16:04:47,13/12/2020 16:04:58,2893703,2900247,6544,111
6182,13/12/2020 16:15:07,13/12/2020 16:15:10,13/12/2020 20:08:37,13/12/2020 20:09:03,273086672,273098910,12238,233
6132,13/12/2020 16:19:29,13/12/2020 16:19:30,13/12/2020 23:54:11,13/12/2020 23:54:20,2900248,2928362,28114,454
6189,13/12/2020 16:17:08,13/12/2020 16:17:10,14/12/2020 05:38:13,14/12/2020 05:38:15,274086703,274117272,30569,801
6120,14/12/2020 10:59:04,14/12/2020 10:59:10,14/12/2020 11:38:09,14/12/2020 11:38:15,493539,495786,2247,39
6147,14/12/2020 08:39:39,14/12/2020 08:39:56,14/12/2020 11:58:44,14/12/2020 11:58:46,207675,216220,8545,199
6132,14/12/2020 15:48:23,14/12/2020 15:48:26,14/12/2020 20:28:34,15/12/2020 07:41:20,2928394,2942216,13822,952
6151,14/12/2020 12:10:19,14/12/2020 12:10:20,14/12/2020 15:56:35,14/12/2020 15:56:40,101509992,101523287,13295,226
6155,14/12/2020 14:25:17,14/12/2020 14:25:18,14/12/2020 19:50:57,14/12/2020 19:50:59,271797587,271803489,5902,325
6189,14/12/2020 15:28:16,14/12/2020 15:28:18,15/12/2020 05:41:24,15/12/2020 05:41:26,274117292,274150913,33621,853
6182,14/12/2020 17:40:08,14/12/2020 17:40:14,14/12/2020 22:15:53,15/12/2020 06:45:37,273098960,273111912,12952,785
6120,14/12/2020 18:14:53,14/12/2020 18:14:58,14/12/2020 20:18:23,15/12/2020 06:53:57,495806,502602,6796,759
6195,15/12/2020 11:40:19,15/12/2020 11:40:20,15/12/2020 11:41:09,15/12/2020 11:41:11,0,23,23,0
6195,15/12/2020 11:58:10,15/12/2020 11:58:11,15/12/2020 11:58:36,15/12/2020 11:58:38,24,36,12,0
6132,15/12/2020 15:47:00,15/12/2020 15:47:02,15/12/2020 22:31:29,16/12/2020 07:47:37,2942232,2963346,21114,960
6133,15/12/2020 18:33:27,15/12/2020 18:33:31,16/12/2020 07:07:31,16/12/2020 07:07:35,347162,363983,16821,754
6168,15/12/2020 19:05:22,15/12/2020 19:05:24,15/12/2020 20:42:52,15/12/2020 20:42:52,273693091,273698903,5812,97
6189,15/12/2020 16:34:38,15/12/2020 16:34:40,16/12/2020 05:34:33,16/12/2020 05:34:35,274150935,274187402,36467,779
6182,15/12/2020 17:43:42,15/12/2020 17:43:47,15/12/2020 21:52:41,16/12/2020 10:09:08,273111939,273123367,11428,985
6115,15/12/2020 15:45:55,15/12/2020 15:45:56,16/12/2020 05:31:14,16/12/2020 13:08:32,373491,422998,49507,1282
6168,16/12/2020 14:06:09,16/12/2020 14:06:11,16/12/2020 18:22:58,16/12/2020 18:22:58,273698941,273714265,15324,256
6193,16/12/2020 09:18:42,16/12/2020 09:18:47,16/12/2020 11:31:26,16/12/2020 14:29:08,276616,283710,7094,310
6189,16/12/2020 16:25:56,16/12/2020 16:25:58,17/12/2020 05:32:41,17/12/2020 05:32:43,274187424,274222510,35086,786
6118,16/12/2020 19:59:47,16/12/2020 19:59:54,17/12/2020 07:37:39,17/12/2020 07:43:02,1834407,1872371,37964,703
6150,17/12/2020 09:36:00,17/12/2020 09:36:02,17/12/2020 12:01:10,17/12/2020 12:01:10,83071,91486,8415,145
6147,17/12/2020 08:33:58,17/12/2020 08:34:13,17/12/2020 11:51:40,17/12/2020 11:51:42,216421,225000,8579,197
6169,17/12/2020 09:35:36,17/12/2020 09:35:38,17/12/2020 13:51:15,17/12/2020 13:51:36,273284998,273299494,14496,256
6120,17/12/2020 10:35:36,17/12/2020 10:35:39,17/12/2020 22:12:55,17/12/2020 22:12:57,502744,545999,43255,697
6189,17/12/2020 15:29:15,17/12/2020 15:29:17,18/12/2020 06:00:08,18/12/2020 06:00:10,274222530,274245418,22888,870
6168,18/12/2020 12:40:48,18/12/2020 12:40:50,18/12/2020 13:17:53,18/12/2020 13:17:53,273714356,273716568,2212,37
6175,18/12/2020 20:23:45,18/12/2020 20:23:49,19/12/2020 03:10:06,19/12/2020 10:59:22,274727270,274747114,19844,875
6133,18/12/2020 20:42:59,18/12/2020 20:43:03,18/12/2020 23:11:50,18/12/2020 23:11:50,364136,373108,8972,148
6118,18/12/2020 19:38:06,18/12/2020 19:38:07,18/12/2020 21:24:10,18/12/2020 21:24:19,1872445,1879239,6794,106
6189,18/12/2020 16:54:20,18/12/2020 16:54:21,19/12/2020 08:40:43,19/12/2020 08:40:45,274245439,274272610,27171,946
6136,18/12/2020 17:27:11,18/12/2020 17:27:13,19/12/2020 08:56:19,19/12/2020 08:56:21,1159724,1192372,32648,929
6132,18/12/2020 19:04:46,18/12/2020 19:04:55,19/12/2020 07:06:57,19/12/2020 10:30:08,2963464,3005182,41718,925
6136,19/12/2020 11:40:34,19/12/2020 11:40:38,19/12/2020 14:46:57,19/12/2020 14:47:09,1192379,1203904,11525,186
6118,19/12/2020 07:36:09,19/12/2020 07:36:10,19/12/2020 12:04:06,19/12/2020 12:04:13,1879254,1896494,17240,268
6155,19/12/2020 14:52:40,19/12/2020 14:52:44,19/12/2020 17:12:04,19/12/2020 17:12:24,271803834,271811292,7458,139
6118,19/12/2020 16:15:21,19/12/2020 16:15:23,19/12/2020 18:58:54,19/12/2020 18:59:04,1896503,1907030,10527,163
6132,19/12/2020 20:50:18,19/12/2020 20:50:19,20/12/2020 06:58:35,20/12/2020 08:43:22,3005203,3039353,34150,713
6143,20/12/2020 10:26:30,20/12/2020 10:27:15,20/12/2020 16:55:53,20/12/2020 16:55:53,1008949,1031862,22913,389
6116,20/12/2020 12:39:02,20/12/2020 12:39:06,20/12/2020 17:14:54,20/12/2020 17:15:34,390488,408403,17915,276
6118,20/12/2020 16:08:14,20/12/2020 16:08:18,20/12/2020 20:27:32,20/12/2020 20:27:32,1907067,1923401,16334,259
6118,20/12/2020 16:08:14,20/12/2020 16:08:18,20/12/2020 20:27:32,20/12/2020 20:27:32,1907067,1923401,16334,259
6118,20/12/2020 16:08:14,20/12/2020 16:08:18,20/12/2020 20:27:32,20/12/2020 20:27:32,1907067,1923401,16334,259
6104,20/12/2020 15:01:53,20/12/2020 15:01:56,20/12/2020 21:03:14,20/12/2020 21:16:42,132107,142583,10476,374
6189,20/12/2020 17:32:29,20/12/2020 17:32:31,21/12/2020 06:49:57,21/12/2020 06:49:59,274272675,274295535,22860,797
6118,21/12/2020 09:19:33,21/12/2020 09:19:37,21/12/2020 15:19:04,21/12/2020 15:19:14,1923429,1943590,20161,359
6189,21/12/2020 16:28:46,21/12/2020 16:28:48,22/12/2020 06:35:14,22/12/2020 06:35:16,274295554,274332250,36696,846
6189,21/12/2020 16:28:46,21/12/2020 16:28:48,22/12/2020 06:35:14,22/12/2020 06:35:16,274295554,274332250,36696,846
6189,21/12/2020 16:28:46,21/12/2020 16:28:48,22/12/2020 06:35:14,22/12/2020 06:35:16,274295554,274332250,36696,846
6118,22/12/2020 06:58:05,22/12/2020 06:58:09,22/12/2020 10:17:19,22/12/2020 10:17:23,1943623,1945781,2158,199
6159,22/12/2020 11:59:50,22/12/2020 11:59:51,22/12/2020 13:30:00,22/12/2020 13:30:06,23541,28266,4725,90
6170,22/12/2020 14:27:11,22/12/2020 14:27:14,22/12/2020 16:08:10,22/12/2020 16:08:12,40236,45992,5756,101
6118,22/12/2020 16:16:50,22/12/2020 16:16:53,22/12/2020 19:31:33,22/12/2020 20:46:59,1945795,1954060,8265,270
6182,22/12/2020 14:31:14,22/12/2020 14:31:18,22/12/2020 20:38:06,22/12/2020 20:47:04,273123690,273134151,10461,375
6189,22/12/2020 16:03:41,22/12/2020 16:03:43,23/12/2020 00:16:26,23/12/2020 07:09:41,274332269,274357439,25170,906
6155,22/12/2020 14:20:58,22/12/2020 14:20:59,23/12/2020 03:47:56,23/12/2020 13:58:43,271811500,271856784,45284,1417
6153,23/12/2020 16:47:49,23/12/2020 16:47:51,23/12/2020 20:43:21,23/12/2020 20:57:47,282632052,282642590,10538,249
6182,23/12/2020 13:46:06,23/12/2020 13:46:12,23/12/2020 18:42:04,23/12/2020 20:45:50,273134188,273148178,13990,419
6189,23/12/2020 16:20:15,23/12/2020 16:20:16,24/12/2020 08:01:48,24/12/2020 08:01:50,274357457,274379686,22229,941
6136,24/12/2020 11:48:08,24/12/2020 11:48:13,24/12/2020 16:38:21,24/12/2020 16:38:21,1204169,1221862,17693,290
6118,24/12/2020 13:01:10,24/12/2020 13:01:11,24/12/2020 13:03:27,24/12/2020 13:04:27,1954122,1954187,65,3
6101,24/12/2020 12:37:40,24/12/2020 12:37:57,24/12/2020 15:49:58,24/12/2020 15:50:35,188207,198380,10173,192
6104,24/12/2020 12:32:06,24/12/2020 12:32:10,24/12/2020 18:38:18,24/12/2020 19:25:42,142846,153435,10589,413
6175,24/12/2020 16:53:58,24/12/2020 16:54:00,24/12/2020 19:31:54,24/12/2020 19:31:56,274747360,274756576,9216,157
6118,24/12/2020 13:05:02,24/12/2020 13:05:03,24/12/2020 21:10:11,24/12/2020 21:43:42,1954187,1983293,29106,518
6132,25/12/2020 00:01:38,25/12/2020 00:01:39,25/12/2020 09:44:20,25/12/2020 12:52:18,3039574,3072018,32444,770
6182,25/12/2020 11:31:55,25/12/2020 11:31:59,25/12/2020 16:37:41,25/12/2020 17:14:11,273148269,273162318,14049,342
6127,25/12/2020 18:37:34,25/12/2020 18:37:35,25/12/2020 21:15:59,25/12/2020 21:16:33,185394,194851,9457,158
6151,25/12/2020 17:42:59,25/12/2020 17:43:05,26/12/2020 12:36:12,26/12/2020 12:36:14,101523833,101590671,66838,1133
6119,26/12/2020 01:30:22,26/12/2020 01:30:23,26/12/2020 14:00:01,26/12/2020 14:04:04,667415,706419,39004,753
6147,26/12/2020 15:09:43,26/12/2020 15:09:46,26/12/2020 19:02:38,26/12/2020 19:02:41,225601,237219,11618,232
6147,26/12/2020 19:07:10,26/12/2020 19:07:11,26/12/2020 19:07:16,26/12/2020 19:11:41,237219,237220,1,4
6147,26/12/2020 19:12:33,26/12/2020 19:12:35,26/12/2020 19:12:39,26/12/2020 19:15:30,237220,237220,0,2
6147,26/12/2020 19:16:12,26/12/2020 19:16:14,26/12/2020 19:16:16,26/12/2020 19:17:04,237220,237220,0,0
6144,26/12/2020 17:14:42,26/12/2020 17:14:46,26/12/2020 23:21:14,27/12/2020 12:10:15,164384,183482,19098,1135
6136,27/12/2020 15:10:50,27/12/2020 15:10:54,27/12/2020 15:47:33,27/12/2020 15:47:46,1222031,1224346,2315,36
6170,27/12/2020 16:12:41,27/12/2020 16:12:41,27/12/2020 16:12:41,27/12/2020 16:23:45,46195,46196,1,11
6118,27/12/2020 16:40:45,27/12/2020 16:40:46,27/12/2020 16:40:59,27/12/2020 16:41:50,1983416,1983416,0,1
6136,27/12/2020 18:13:38,27/12/2020 18:13:43,27/12/2020 23:39:29,28/12/2020 10:04:05,1224356,1243929,19573,950
6170,27/12/2020 16:24:16,27/12/2020 16:26:19,27/12/2020 18:36:39,27/12/2020 18:36:48,46196,53561,7365,132
6118,27/12/2020 16:42:30,27/12/2020 16:42:31,27/12/2020 19:58:04,27/12/2020 20:01:35,1983416,1983433,17,199
6118,27/12/2020 20:02:54,27/12/2020 20:02:55,27/12/2020 20:03:14,27/12/2020 20:05:41,1983433,1983434,1,2
6118,27/12/2020 20:06:43,27/12/2020 20:06:44,27/12/2020 20:06:53,27/12/2020 20:07:13,1983434,1983434,0,0
6118,27/12/2020 20:08:30,27/12/2020 20:08:31,27/12/2020 20:08:44,27/12/2020 20:09:00,1983434,1983434,0,0
6189,27/12/2020 12:44:56,27/12/2020 12:44:58,28/12/2020 08:54:57,28/12/2020 08:54:59,274379838,274403798,23960,1210
6150,28/12/2020 13:03:51,28/12/2020 13:03:54,29/12/2020 07:17:52,29/12/2020 07:17:54,92052,110146,18094,1094
6118,28/12/2020 13:13:03,28/12/2020 13:13:06,28/12/2020 16:51:57,28/12/2020 17:29:10,1983462,1991701,8239,256
6104,28/12/2020 13:14:24,28/12/2020 13:14:28,28/12/2020 18:41:59,28/12/2020 18:58:06,153707,163085,9378,343
6118,28/12/2020 21:42:06,28/12/2020 21:42:07,28/12/2020 21:42:39,28/12/2020 21:44:03,1991706,1991712,6,1
6189,28/12/2020 14:55:05,28/12/2020 14:55:07,29/12/2020 08:49:39,29/12/2020 08:49:41,274403810,274416702,12892,1074
6153,29/12/2020 11:46:17,29/12/2020 11:46:20,29/12/2020 15:50:01,29/12/2020 16:03:24,282642862,282652972,10110,257
6133,28/12/2020 18:27:02,28/12/2020 18:27:03,29/12/2020 08:40:32,29/12/2020 12:07:34,373716,423344,49628,1060
6155,28/12/2020 14:26:40,28/12/2020 14:44:19,29/12/2020 13:19:32,29/12/2020 13:19:49,271857147,271857278,131,1373
6108,29/12/2020 13:25:15,29/12/2020 13:25:16,29/12/2020 15:00:08,29/12/2020 15:00:13,95563,101233,5670,94
6175,29/12/2020 12:04:36,29/12/2020 12:04:37,30/12/2020 08:00:41,30/12/2020 08:00:43,274756801,274790229,33428,1196
6189,30/12/2020 08:40:42,30/12/2020 08:40:44,30/12/2020 10:41:40,30/12/2020 10:41:42,274416749,274423480,6731,121
6184,29/12/2020 15:58:11,29/12/2020 15:58:12,30/12/2020 06:52:31,30/12/2020 12:12:00,265842,317531,51689,1213
6143,30/12/2020 12:28:53,30/12/2020 12:28:53,30/12/2020 12:28:53,30/12/2020 12:29:27,1032355,1032355,0,0
6143,30/12/2020 12:30:02,30/12/2020 12:30:08,30/12/2020 18:46:53,30/12/2020 18:46:53,1032355,1054484,22129,376
6108,30/12/2020 12:41:19,30/12/2020 12:41:20,30/12/2020 14:45:47,30/12/2020 14:47:10,101287,108731,7444,125
6155,30/12/2020 10:50:48,30/12/2020 11:30:53,30/12/2020 15:25:08,30/12/2020 15:25:25,271857343,271857367,24,274
6132,30/12/2020 18:08:39,30/12/2020 18:08:41,31/12/2020 03:27:56,31/12/2020 09:41:30,3072268,3102440,30172,932
6146,30/12/2020 15:46:43,30/12/2020 15:46:44,30/12/2020 18:30:51,30/12/2020 18:30:59,144658,153894,9236,164
6189,30/12/2020 12:59:37,30/12/2020 12:59:39,31/12/2020 08:24:14,31/12/2020 08:24:16,274423484,274436768,13284,1164
6155,30/12/2020 17:43:17,30/12/2020 17:43:19,31/12/2020 10:35:42,31/12/2020 10:38:19,271857374,271857472,98,1015
6118,31/12/2020 16:57:31,31/12/2020 16:57:32,31/12/2020 16:58:34,31/12/2020 16:58:54,1991843,1991853,10,1
6118,31/12/2020 16:59:20,31/12/2020 16:59:21,31/12/2020 17:06:17,31/12/2020 17:18:00,1991853,1992259,406,18
6118,31/12/2020 17:18:25,31/12/2020 17:18:26,31/12/2020 17:19:18,31/12/2020 17:20:12,1992259,1992266,7,1
6118,31/12/2020 18:28:13,31/12/2020 18:28:14,31/12/2020 18:32:51,31/12/2020 18:50:25,1992268,1992518,250,22
6175,31/12/2020 20:10:36,31/12/2020 20:10:39,31/12/2020 21:47:05,31/12/2020 21:47:36,274790302,274795947,5645,97
6175,31/12/2020 21:47:58,31/12/2020 21:48:03,01/01/2021 00:33:28,01/01/2021 11:33:41,274795947,274805457,9510,825
6120,31/12/2020 21:33:10,31/12/2020 21:33:16,31/12/2020 23:43:40,01/01/2021 08:04:14,546851,553887,7036,631
6132,31/12/2020 22:31:02,31/12/2020 22:31:03,01/01/2021 06:44:59,01/01/2021 09:09:35,3102465,3129492,27027,638
6189,31/12/2020 19:35:55,31/12/2020 19:35:57,01/01/2021 04:01:57,01/01/2021 10:44:12,274436789,274462346,25557,908
6143,01/01/2021 14:07:24,01/01/2021 14:07:28,01/01/2021 17:36:48,01/01/2021 17:37:01,1054597,1067177,12580,209
6118,01/01/2021 15:45:14,01/01/2021 15:45:15,01/01/2021 22:38:09,01/01/2021 22:38:15,1992551,2016787,24236,413
6169,02/01/2021 14:26:19,02/01/2021 14:26:22,02/01/2021 17:10:29,02/01/2021 18:29:00,273300307,273305126,4819,242
6147,03/01/2021 11:00:19,03/01/2021 11:00:22,03/01/2021 14:34:38,03/01/2021 15:07:48,237735,245803,8068,247
6151,02/01/2021 16:36:15,02/01/2021 16:36:16,03/01/2021 17:13:29,03/01/2021 17:13:31,101591057,101676427,85370,1477
6119,03/01/2021 14:52:30,03/01/2021 14:52:31,03/01/2021 19:36:27,03/01/2021 19:36:31,706941,717237,10296,284
6172,03/01/2021 20:05:07,03/01/2021 20:05:09,03/01/2021 20:21:29,03/01/2021 20:21:31,304563089,304564020,931,16
6182,03/01/2021 16:28:09,03/01/2021 16:28:15,03/01/2021 21:06:18,03/01/2021 23:26:03,273162799,273175151,12352,417
6189,03/01/2021 15:12:45,03/01/2021 15:12:46,04/01/2021 07:30:57,04/01/2021 07:30:59,274462449,274484988,22539,978
6147,04/01/2021 13:26:16,04/01/2021 13:26:16,04/01/2021 13:26:16,04/01/2021 13:27:37,245866,245866,0,1
6147,04/01/2021 13:28:11,04/01/2021 13:28:11,04/01/2021 13:28:11,04/01/2021 13:29:47,245866,245866,0,1
6147,04/01/2021 13:30:27,04/01/2021 13:30:27,04/01/2021 13:30:27,04/01/2021 13:33:17,245866,245867,1,2
6118,04/01/2021 09:31:52,04/01/2021 09:31:58,04/01/2021 15:43:31,04/01/2021 15:43:42,2016877,2038539,21662,371
6183,04/01/2021 15:45:42,04/01/2021 15:45:44,04/01/2021 15:47:56,04/01/2021 15:48:02,304557269,304557397,128,2
6183,04/01/2021 15:48:31,04/01/2021 15:48:33,05/01/2021 07:09:55,05/01/2021 08:12:52,304557397,304588936,31539,984
6118,04/01/2021 17:47:28,04/01/2021 17:47:29,04/01/2021 17:47:58,04/01/2021 17:49:44,2038545,2038545,0,2
6118,04/01/2021 19:01:43,04/01/2021 19:01:44,04/01/2021 19:05:25,04/01/2021 19:09:23,2038547,2038735,188,7
6189,04/01/2021 15:34:51,04/01/2021 15:34:53,05/01/2021 07:05:44,05/01/2021 07:05:46,274485004,274516562,31558,930
6188,05/01/2021 14:33:58,05/01/2021 14:33:59,06/01/2021 06:29:29,06/01/2021 09:28:41,274222306,274276629,54323,1134
6118,05/01/2021 14:06:08,05/01/2021 14:06:13,05/01/2021 17:38:19,05/01/2021 17:55:45,2038770,2050960,12190,229
6175,04/01/2021 20:58:09,04/01/2021 20:58:10,05/01/2021 14:25:36,05/01/2021 18:05:35,274805624,274839120,33496,1267
6175,05/01/2021 19:20:34,05/01/2021 19:20:39,06/01/2021 02:02:30,06/01/2021 07:19:44,274839124,274858563,19439,719
6189,05/01/2021 16:29:59,05/01/2021 16:30:01,06/01/2021 06:20:11,06/01/2021 06:20:13,274516581,274553517,36936,830
6120,05/01/2021 17:06:35,05/01/2021 17:06:40,05/01/2021 19:17:09,06/01/2021 06:55:50,554161,561245,7084,829
6189,06/01/2021 15:24:06,06/01/2021 15:24:08,06/01/2021 16:47:29,06/01/2021 16:47:31,274553535,274558151,4616,83
6118,06/01/2021 11:50:11,06/01/2021 11:50:14,06/01/2021 19:10:43,06/01/2021 19:16:59,2050993,2076243,25250,446
6189,06/01/2021 17:11:02,06/01/2021 17:11:04,07/01/2021 07:40:25,07/01/2021 07:40:27,274558152,274586695,28543,869
6120,06/01/2021 15:34:03,06/01/2021 15:34:06,06/01/2021 17:22:02,07/01/2021 08:08:49,561267,567088,5821,994
6193,06/01/2021 16:11:17,06/01/2021 16:11:21,06/01/2021 18:29:40,07/01/2021 08:44:49,284733,292103,7370,993
6148,06/01/2021 16:49:58,06/01/2021 16:50:02,07/01/2021 00:04:05,07/01/2021 10:14:57,96540,119926,23386,1044
6118,07/01/2021 18:46:26,07/01/2021 18:46:28,07/01/2021 18:46:34,07/01/2021 18:47:30,2076290,2076290,0,1
6118,07/01/2021 18:48:26,07/01/2021 18:48:27,07/01/2021 18:48:38,07/01/2021 18:49:40,2076290,2076290,0,1
6147,07/01/2021 11:43:37,07/01/2021 11:43:41,07/01/2021 15:07:09,07/01/2021 21:25:05,246062,254173,8111,581
6189,07/01/2021 15:25:27,07/01/2021 15:25:29,08/01/2021 07:38:31,08/01/2021 07:38:33,274586710,274616637,29927,973
6155,07/01/2021 08:55:06,07/01/2021 12:19:24,08/01/2021 10:42:22,08/01/2021 10:43:40,271857972,271858114,142,1548
6153,08/01/2021 10:44:25,08/01/2021 10:44:29,08/01/2021 14:39:32,08/01/2021 14:39:32,282653444,282663570,10126,235
6147,08/01/2021 12:21:09,08/01/2021 12:21:12,08/01/2021 15:58:06,08/01/2021 17:30:44,254216,262636,8420,309
6103,08/01/2021 19:08:46,08/01/2021 19:08:53,09/01/2021 00:23:03,09/01/2021 07:40:32,109804,127553,17749,751
6104,08/01/2021 14:31:04,08/01/2021 14:31:07,08/01/2021 20:36:07,08/01/2021 20:49:19,163870,174310,10440,378
6120,09/01/2021 07:22:11,09/01/2021 07:22:15,09/01/2021 08:18:45,09/01/2021 08:19:11,567213,570510,3297,57
6189,09/01/2021 07:33:04,09/01/2021 07:33:06,09/01/2021 10:15:12,09/01/2021 10:15:14,274616684,274625677,8993,162
6184,08/01/2021 14:06:47,08/01/2021 14:06:48,09/01/2021 09:05:24,09/01/2021 11:36:03,317997,383448,65451,1289
6120,09/01/2021 10:43:36,09/01/2021 10:43:41,09/01/2021 12:51:30,09/01/2021 14:03:33,570517,577471,6954,199
6189,09/01/2021 10:17:22,09/01/2021 10:17:24,09/01/2021 18:37:59,10/01/2021 09:36:31,274625677,274650577,24900,1399
6143,10/01/2021 10:09:51,10/01/2021 10:09:55,10/01/2021 12:36:42,10/01/2021 12:37:12,1080017,1088785,8768,147
6121,09/01/2021 16:20:34,09/01/2021 16:20:39,10/01/2021 00:09:03,10/01/2021 10:56:39,117425,142996,25571,1116
6143,10/01/2021 12:37:48,10/01/2021 12:37:53,10/01/2021 17:46:32,10/01/2021 17:46:32,1088785,1107239,18454,308
6132,10/01/2021 14:30:38,10/01/2021 14:30:40,11/01/2021 00:28:56,11/01/2021 09:23:41,3129934,3161478,31544,1133
6147,11/01/2021 16:40:29,11/01/2021 16:40:33,11/01/2021 20:22:07,11/01/2021 20:52:20,262836,271040,8204,251
6155,12/01/2021 09:00:40,12/01/2021 09:00:41,12/01/2021 09:00:46,12/01/2021 09:01:19,271858397,271858397,0,0
6118,12/01/2021 12:33:32,12/01/2021 12:33:32,12/01/2021 12:33:32,12/01/2021 12:34:00,2076495,2076495,0,0
6118,12/01/2021 12:34:37,12/01/2021 12:34:38,12/01/2021 12:42:04,12/01/2021 12:42:37,2076495,2076868,373,8
6150,12/01/2021 15:23:59,12/01/2021 15:24:01,12/01/2021 22:47:11,13/01/2021 13:51:11,110872,133267,22395,1347
6118,12/01/2021 12:45:52,12/01/2021 12:45:53,12/01/2021 15:44:51,12/01/2021 16:09:13,2076868,2087127,10259,203
6139,13/01/2021 13:48:21,13/01/2021 13:48:23,13/01/2021 14:42:40,13/01/2021 14:42:42,271504,274571,3067,54
6143,13/01/2021 17:10:18,13/01/2021 17:10:22,13/01/2021 21:33:27,13/01/2021 21:33:31,1107388,1123187,15799,263
6175,13/01/2021 18:30:18,13/01/2021 18:30:19,13/01/2021 18:31:43,13/01/2021 18:33:07,274858921,274858921,0,2
6118,13/01/2021 12:06:41,13/01/2021 12:06:48,13/01/2021 19:24:31,13/01/2021 19:24:45,2087156,2112730,25574,438
6189,13/01/2021 18:06:34,13/01/2021 18:06:36,14/01/2021 00:33:33,14/01/2021 09:05:33,274650735,274669337,18602,898
6116,14/01/2021 15:07:35,14/01/2021 15:07:41,14/01/2021 18:52:32,14/01/2021 18:53:38,409604,424142,14538,226
6175,13/01/2021 21:52:50,13/01/2021 21:52:51,14/01/2021 15:19:06,14/01/2021 15:19:08,274858928,274890753,31825,1046
6118,14/01/2021 17:06:25,14/01/2021 17:06:26,14/01/2021 18:11:46,14/01/2021 18:12:31,2112779,2116988,4209,66
6104,14/01/2021 18:36:17,14/01/2021 18:36:22,14/01/2021 23:46:17,15/01/2021 06:39:27,174739,190625,15886,723
6132,14/01/2021 20:07:46,14/01/2021 20:07:53,15/01/2021 08:44:08,15/01/2021 08:44:10,3161644,3202003,40359,756
6189,15/01/2021 09:25:30,15/01/2021 09:25:31,15/01/2021 10:27:18,15/01/2021 10:27:20,274669385,274672803,3418,61
6143,15/01/2021 14:46:55,15/01/2021 14:46:58,15/01/2021 20:30:15,15/01/2021 20:30:15,1123279,1143606,20327,343
6186,15/01/2021 15:43:46,15/01/2021 15:43:52,15/01/2021 21:11:26,15/01/2021 21:12:17,272926085,272945890,19805,328
6174,15/01/2021 14:20:53,15/01/2021 14:20:54,15/01/2021 20:37:53,15/01/2021 20:38:20,273034615,273047597,12982,377
6143,16/01/2021 14:44:15,16/01/2021 14:44:19,16/01/2021 16:28:33,16/01/2021 16:28:33,1143648,1150012,6364,104
6189,16/01/2021 12:02:14,16/01/2021 12:02:15,16/01/2021 16:04:59,16/01/2021 16:05:01,274672854,274686349,13495,242
6161,16/01/2021 21:42:09,16/01/2021 21:42:15,16/01/2021 21:42:15,16/01/2021 21:42:15,305330285,305330285,0,0
6120,16/01/2021 15:43:03,16/01/2021 15:43:07,16/01/2021 17:51:19,17/01/2021 08:12:42,577899,584834,6935,989
6136,17/01/2021 10:00:12,17/01/2021 10:00:15,17/01/2021 14:43:23,17/01/2021 14:57:41,1245063,1261910,16847,297
6118,17/01/2021 10:22:12,17/01/2021 10:22:15,17/01/2021 13:41:12,17/01/2021 16:23:49,2117137,2125240,8103,361
6120,17/01/2021 11:59:22,17/01/2021 11:59:28,17/01/2021 17:44:34,17/01/2021 18:35:06,584844,602659,17815,395
6175,16/01/2021 19:54:16,16/01/2021 19:54:17,17/01/2021 12:32:22,17/01/2021 12:32:24,274890859,274907369,16510,998
6104,17/01/2021 15:37:51,17/01/2021 15:37:56,17/01/2021 15:38:06,17/01/2021 15:38:06,190798,190803,5,0
6104,17/01/2021 15:38:46,17/01/2021 15:38:47,17/01/2021 17:57:54,17/01/2021 17:57:54,190804,198706,7902,139
6132,17/01/2021 15:34:35,17/01/2021 15:34:38,17/01/2021 16:25:30,17/01/2021 16:25:34,3202113,3204898,2785,50
6104,17/01/2021 15:38:46,17/01/2021 15:38:47,17/01/2021 17:57:54,17/01/2021 17:57:54,190804,198706,7902,139
6104,17/01/2021 15:38:46,17/01/2021 15:38:47,17/01/2021 17:57:54,17/01/2021 17:57:54,190804,198706,7902,139
6119,17/01/2021 13:18:50,17/01/2021 13:18:52,18/01/2021 04:37:32,18/01/2021 06:44:14,718158,765667,47509,1045
6189,17/01/2021 17:20:45,17/01/2021 17:20:48,18/01/2021 08:11:17,18/01/2021 08:11:19,274686399,274703177,16778,890
6175,18/01/2021 19:01:32,18/01/2021 19:01:37,19/01/2021 01:44:41,19/01/2021 10:40:20,274907430,274926739,19309,938
6193,18/01/2021 15:46:29,18/01/2021 15:46:34,18/01/2021 17:59:03,19/01/2021 08:48:45,292653,299723,7070,1022
6189,18/01/2021 17:08:00,18/01/2021 17:08:01,19/01/2021 03:53:15,19/01/2021 09:15:12,274703195,274736405,33210,967
6175,18/01/2021 19:01:32,18/01/2021 19:01:37,19/01/2021 01:44:41,19/01/2021 10:40:20,274907430,274926739,19309,938
6175,18/01/2021 19:01:32,18/01/2021 19:01:37,19/01/2021 01:44:41,19/01/2021 10:40:20,274907430,274926739,19309,938
6118,19/01/2021 10:10:38,19/01/2021 10:10:41,19/01/2021 18:25:36,19/01/2021 19:06:44,2125327,2153828,28501,536
6120,19/01/2021 17:23:27,19/01/2021 17:23:31,19/01/2021 19:31:03,20/01/2021 08:12:57,602779,609748,6969,889
6193,20/01/2021 09:20:26,20/01/2021 09:20:30,20/01/2021 11:33:36,20/01/2021 15:04:41,299772,306882,7110,344
6120,20/01/2021 13:51:05,20/01/2021 13:51:51,20/01/2021 18:57:55,20/01/2021 18:57:57,609763,623255,13492,306
6118,21/01/2021 08:30:20,21/01/2021 08:30:23,21/01/2021 12:01:00,21/01/2021 15:29:41,2153875,2162322,8447,419
6125,21/01/2021 12:17:39,21/01/2021 12:17:44,21/01/2021 15:22:19,21/01/2021 15:23:57,137034,142509,5475,186
6193,21/01/2021 15:46:10,21/01/2021 15:46:14,21/01/2021 17:52:50,21/01/2021 17:53:28,306934,314007,7073,127
6175,21/01/2021 19:12:11,21/01/2021 19:12:12,21/01/2021 19:12:39,21/01/2021 19:13:09,274926852,274926852,0,0
6104,21/01/2021 19:51:21,21/01/2021 19:51:26,21/01/2021 22:28:03,21/01/2021 22:28:16,199002,208662,9660,156
6120,22/01/2021 06:39:42,22/01/2021 06:39:47,22/01/2021 07:54:09,22/01/2021 07:54:47,623366,627715,4349,75
6193,22/01/2021 11:43:24,22/01/2021 11:43:29,22/01/2021 13:54:43,22/01/2021 14:55:44,314046,321090,7044,192
6120,22/01/2021 10:51:36,22/01/2021 10:51:40,22/01/2021 16:58:59,22/01/2021 17:06:16,627723,638446,10723,374
6118,22/01/2021 15:47:34,22/01/2021 15:47:35,22/01/2021 20:01:59,22/01/2021 20:02:30,2162354,2168423,6069,254
6175,21/01/2021 19:13:35,21/01/2021 19:13:36,22/01/2021 21:42:24,22/01/2021 21:42:26,274926852,274960769,33917,1588
6163,23/01/2021 08:20:24,23/01/2021 08:20:28,23/01/2021 09:02:31,23/01/2021 09:03:32,290574461,290576896,2435,43
6116,23/01/2021 15:57:40,23/01/2021 15:57:41,23/01/2021 15:57:47,23/01/2021 15:59:03,424571,424572,1,1
6143,23/01/2021 15:59:26,23/01/2021 15:59:30,23/01/2021 20:06:36,23/01/2021 20:06:36,1150370,1165311,14941,247
6116,23/01/2021 15:59:27,23/01/2021 15:59:28,23/01/2021 15:59:33,23/01/2021 16:04:53,424572,424572,0,5
6175,24/01/2021 08:11:09,24/01/2021 08:11:13,24/01/2021 14:59:57,24/01/2021 15:53:33,274960838,274980438,19600,462
6175,24/01/2021 08:11:09,24/01/2021 08:11:13,24/01/2021 14:59:57,24/01/2021 15:53:33,274960838,274980438,19600,462
6175,24/01/2021 08:11:09,24/01/2021 08:11:13,24/01/2021 14:59:57,24/01/2021 15:53:33,274960838,274980438,19600,462
6182,24/01/2021 11:05:07,24/01/2021 11:05:12,24/01/2021 14:47:39,24/01/2021 18:08:14,273176262,273185461,9199,423
6136,24/01/2021 22:29:01,24/01/2021 22:29:03,25/01/2021 02:47:22,25/01/2021 02:47:24,1262340,1276983,14643,258
6189,24/01/2021 15:45:50,24/01/2021 15:45:53,25/01/2021 08:24:10,25/01/2021 08:24:12,274736653,274756088,19435,998
6133,25/01/2021 10:47:59,25/01/2021 10:48:03,25/01/2021 18:17:57,25/01/2021 18:19:16,425039,444763,19724,451
6151,24/01/2021 14:37:00,24/01/2021 14:37:01,25/01/2021 13:12:53,25/01/2021 13:12:56,101677444,101752799,75355,1355
6118,25/01/2021 16:04:13,25/01/2021 16:04:31,25/01/2021 21:17:08,25/01/2021 21:17:16,2168518,2186672,18154,313
6189,25/01/2021 20:03:03,25/01/2021 20:03:04,26/01/2021 06:37:59,26/01/2021 06:38:01,274756112,274767503,11391,634
6118,26/01/2021 08:30:37,26/01/2021 08:30:52,26/01/2021 10:19:56,26/01/2021 10:36:14,2186691,2192605,5914,125
6155,26/01/2021 10:54:30,26/01/2021 10:54:35,26/01/2021 15:29:52,26/01/2021 15:30:14,271859416,271873138,13722,275
6182,26/01/2021 13:53:52,26/01/2021 13:53:59,26/01/2021 15:32:37,26/01/2021 15:32:43,273185570,273191495,5925,98
6143,26/01/2021 15:35:06,26/01/2021 15:35:09,26/01/2021 19:56:34,26/01/2021 19:56:34,1165463,1180808,15345,261
6189,26/01/2021 15:54:56,26/01/2021 15:54:58,27/01/2021 06:35:01,27/01/2021 06:35:03,274767521,274796210,28689,880
6175,27/01/2021 18:07:22,27/01/2021 18:07:26,28/01/2021 00:28:38,28/01/2021 10:49:22,274980587,274998916,18329,1002
6104,27/01/2021 20:47:41,27/01/2021 20:47:47,28/01/2021 00:14:44,28/01/2021 06:33:35,209093,218988,9895,585
6189,27/01/2021 17:02:34,27/01/2021 17:02:36,28/01/2021 00:53:21,28/01/2021 06:38:29,274796231,274819887,23656,815
6193,28/01/2021 09:31:55,28/01/2021 09:32:00,28/01/2021 11:44:36,28/01/2021 12:01:39,321373,328502,7129,149
6193,28/01/2021 09:31:55,28/01/2021 09:32:00,28/01/2021 11:44:36,28/01/2021 12:01:39,321373,328502,7129,149
6193,28/01/2021 09:31:55,28/01/2021 09:32:00,28/01/2021 11:44:36,28/01/2021 12:01:39,321373,328502,7129,149
6193,28/01/2021 09:31:55,28/01/2021 09:32:00,28/01/2021 11:44:36,28/01/2021 12:01:39,321373,328502,7129,149
6193,28/01/2021 09:31:55,28/01/2021 09:32:00,28/01/2021 11:44:36,28/01/2021 12:01:39,321373,328502,7129,149
6177,28/01/2021 14:25:09,28/01/2021 14:25:11,28/01/2021 14:48:45,28/01/2021 14:49:03,62405,63759,1354,23
6104,28/01/2021 21:22:17,28/01/2021 21:22:22,29/01/2021 00:47:02,29/01/2021 06:38:03,219033,229050,10017,555
6189,28/01/2021 15:40:51,28/01/2021 15:40:54,29/01/2021 07:13:48,29/01/2021 07:13:50,274819905,274848855,28950,932
6177,29/01/2021 15:19:59,29/01/2021 15:20:01,29/01/2021 15:22:47,29/01/2021 15:22:55,63808,63973,165,2
6175,29/01/2021 13:53:56,29/01/2021 13:53:57,29/01/2021 21:02:17,29/01/2021 21:02:19,274998970,275024405,25435,428
6189,29/01/2021 15:38:41,29/01/2021 15:38:43,30/01/2021 01:13:22,30/01/2021 09:08:52,274848872,274878390,29518,1050
6127,30/01/2021 11:58:11,30/01/2021 11:58:15,30/01/2021 14:59:04,30/01/2021 14:59:11,205135,216498,11363,181
6187,30/01/2021 12:02:40,30/01/2021 12:02:42,30/01/2021 14:57:23,30/01/2021 14:57:25,27660,37167,9507,174
6143,31/01/2021 10:25:41,31/01/2021 10:25:44,31/01/2021 14:56:39,31/01/2021 14:57:20,1181039,1197186,16147,271
6175,30/01/2021 22:43:36,30/01/2021 22:43:37,31/01/2021 11:35:01,31/01/2021 11:35:03,275024457,275040102,15645,771
6186,31/01/2021 11:57:43,31/01/2021 11:57:47,01/02/2021 00:10:03,01/02/2021 07:28:07,272946649,272987470,40821,1170
6132,31/01/2021 12:07:24,31/01/2021 12:07:24,31/01/2021 12:07:24,31/01/2021 12:09:22,3205560,3205560,0,1
6132,31/01/2021 12:11:34,31/01/2021 12:11:34,31/01/2021 12:11:34,31/01/2021 12:11:41,3205560,3205560,0,0
6132,31/01/2021 12:12:17,31/01/2021 12:12:25,31/01/2021 15:26:48,31/01/2021 15:27:00,3205560,3215977,10417,194
6188,31/01/2021 12:32:19,31/01/2021 12:32:20,31/01/2021 22:37:29,31/01/2021 22:55:06,274278142,274311036,32894,622
6184,30/01/2021 17:01:44,30/01/2021 17:01:45,31/01/2021 11:45:18,31/01/2021 14:08:52,384534,449884,65350,1267
6143,31/01/2021 14:57:47,31/01/2021 14:57:52,31/01/2021 17:38:27,31/01/2021 17:38:30,1197186,1206158,8972,160
6136,31/01/2021 15:05:02,31/01/2021 15:05:07,31/01/2021 21:29:39,31/01/2021 22:02:01,1277370,1299665,22295,416
6168,31/01/2021 14:24:59,31/01/2021 14:25:06,31/01/2021 16:18:01,31/01/2021 16:18:57,273718902,273724772,5870,113
6184,31/01/2021 17:05:04,31/01/2021 17:05:08,31/01/2021 22:01:07,31/01/2021 22:01:26,449892,462947,13055,296
6189,31/01/2021 15:39:43,31/01/2021 15:39:45,31/01/2021 17:05:13,31/01/2021 17:05:15,274878451,274883198,4747,85
6104,31/01/2021 12:08:08,31/01/2021 12:08:13,31/01/2021 17:34:53,31/01/2021 17:53:01,229212,245786,16574,344
6189,31/01/2021 17:38:44,31/01/2021 17:38:46,01/02/2021 07:03:09,01/02/2021 07:03:11,274883199,274888712,5513,804
6172,01/02/2021 08:52:56,01/02/2021 08:52:57,01/02/2021 10:47:08,01/02/2021 12:39:38,304565382,304570430,5048,226
6112,01/02/2021 18:14:35,01/02/2021 18:14:37,01/02/2021 19:12:45,01/02/2021 19:12:59,137782,141188,3406,58
6186,01/02/2021 11:34:30,01/02/2021 11:34:31,01/02/2021 21:56:23,01/02/2021 21:56:45,272987479,273025205,37726,622
6189,01/02/2021 14:50:26,01/02/2021 14:50:28,02/02/2021 06:37:00,02/02/2021 06:37:02,274888728,274920671,31943,946
6118,01/02/2021 21:52:22,01/02/2021 21:52:35,02/02/2021 07:06:18,02/02/2021 07:06:36,2192943,2225186,32243,554
6175,02/02/2021 16:01:00,02/02/2021 16:01:02,02/02/2021 19:35:00,02/02/2021 19:35:04,275040207,275053261,13054,214
6189,02/02/2021 15:45:21,02/02/2021 15:45:23,03/02/2021 06:32:55,03/02/2021 06:32:57,274920689,274944823,24134,887
6175,03/02/2021 22:47:25,03/02/2021 22:47:26,03/02/2021 22:48:06,03/02/2021 22:48:29,275053316,275053337,21,1
6189,03/02/2021 17:20:30,03/02/2021 17:20:32,04/02/2021 06:42:22,04/02/2021 06:42:24,274944844,274979330,34486,801
6193,04/02/2021 09:19:22,04/02/2021 09:19:27,04/02/2021 11:27:20,04/02/2021 13:40:11,328841,335684,6843,260
6115,04/02/2021 18:30:17,04/02/2021 18:30:17,04/02/2021 18:30:17,04/02/2021 18:33:15,425567,425567,0,2
6115,04/02/2021 18:33:32,04/02/2021 18:33:32,04/02/2021 18:33:32,04/02/2021 18:34:00,425568,425568,0,0
6155,04/02/2021 15:58:55,04/02/2021 15:58:59,04/02/2021 18:36:07,04/02/2021 18:36:26,271873786,271878354,4568,157
6155,04/02/2021 15:58:55,04/02/2021 15:58:59,04/02/2021 18:36:07,04/02/2021 18:36:26,271873786,271878354,4568,157
6155,04/02/2021 15:58:55,04/02/2021 15:58:59,04/02/2021 18:36:07,04/02/2021 18:36:26,271873786,271878354,4568,157
6175,03/02/2021 22:48:47,03/02/2021 22:48:49,04/02/2021 18:44:54,04/02/2021 18:44:56,275053337,275059436,6099,1196
6175,03/02/2021 22:48:47,03/02/2021 22:48:49,04/02/2021 18:44:54,04/02/2021 18:44:56,275053337,275059436,6099,1196
6175,03/02/2021 22:48:47,03/02/2021 22:48:49,04/02/2021 18:44:54,04/02/2021 18:44:56,275053337,275059436,6099,1196
6175,04/02/2021 20:22:02,04/02/2021 20:22:06,05/02/2021 00:33:20,05/02/2021 13:23:49,275059439,275067035,7596,1021
6189,04/02/2021 16:20:43,04/02/2021 16:20:45,05/02/2021 06:32:05,05/02/2021 06:32:07,274979350,275010748,31398,851
6151,04/02/2021 11:56:44,04/02/2021 11:56:45,05/02/2021 11:14:18,05/02/2021 11:14:23,101753491,101829911,76420,1397
6153,05/02/2021 11:51:44,05/02/2021 11:51:48,05/02/2021 15:49:43,05/02/2021 15:49:43,282664921,282675367,10446,237
6175,05/02/2021 14:27:24,05/02/2021 14:27:28,05/02/2021 16:47:01,05/02/2021 16:47:10,275067037,275075411,8374,139
6118,05/02/2021 19:35:46,05/02/2021 19:35:54,06/02/2021 05:05:30,06/02/2021 06:42:14,2225372,2258216,32844,666
6189,05/02/2021 15:25:53,05/02/2021 15:25:56,05/02/2021 23:22:35,06/02/2021 08:52:21,275010766,275034670,23904,1046
6142,06/02/2021 13:30:11,06/02/2021 13:30:15,06/02/2021 17:21:39,06/02/2021 17:22:18,476831,490831,14000,232
6143,06/02/2021 16:04:45,06/02/2021 16:04:48,06/02/2021 20:08:57,06/02/2021 20:09:07,1206452,1220949,14497,244
6182,06/02/2021 09:50:06,06/02/2021 09:50:09,06/02/2021 15:57:34,06/02/2021 16:14:40,273192088,273202617,10529,384
6104,06/02/2021 20:09:49,06/02/2021 20:09:53,06/02/2021 23:43:48,07/02/2021 10:03:30,246228,256231,10003,833
6189,07/02/2021 13:06:21,07/02/2021 13:06:23,07/02/2021 16:28:51,07/02/2021 16:28:53,275034726,275045986,11260,202
6189,07/02/2021 13:06:21,07/02/2021 13:06:23,07/02/2021 16:28:51,07/02/2021 16:28:53,275034726,275045986,11260,202
6189,07/02/2021 13:06:21,07/02/2021 13:06:23,07/02/2021 16:28:51,07/02/2021 16:28:53,275034726,275045986,11260,202
6189,07/02/2021 21:12:26,07/02/2021 21:12:33,08/02/2021 00:13:25,08/02/2021 00:23:24,275045996,275055715,9719,190
6142,08/02/2021 14:37:25,08/02/2021 14:37:29,08/02/2021 22:43:47,09/02/2021 09:59:24,490953,518625,27672,1161
6175,08/02/2021 16:08:27,08/02/2021 16:08:31,08/02/2021 22:10:49,09/02/2021 09:11:35,275075554,275092351,16797,1023
6143,08/02/2021 17:36:25,08/02/2021 17:36:29,08/02/2021 21:47:35,08/02/2021 21:47:46,1221049,1235789,14740,251
6189,08/02/2021 13:30:05,08/02/2021 13:30:07,09/02/2021 06:30:05,09/02/2021 06:30:07,275055742,275087756,32014,1020
6182,08/02/2021 19:50:36,08/02/2021 19:50:40,09/02/2021 00:54:35,09/02/2021 06:34:45,273202739,273216608,13869,644
6143,09/02/2021 12:23:24,09/02/2021 12:23:28,09/02/2021 18:48:52,09/02/2021 18:48:54,1235822,1257236,21414,385
6189,09/02/2021 16:11:30,09/02/2021 16:11:32,10/02/2021 06:25:42,10/02/2021 06:25:44,275087775,275110588,22813,854
6147,10/02/2021 12:55:37,10/02/2021 12:55:40,10/02/2021 16:25:15,10/02/2021 16:25:17,273014,281496,8482,209
6189,10/02/2021 16:07:39,10/02/2021 16:07:41,11/02/2021 06:51:52,11/02/2021 06:51:54,275110607,275130443,19836,884
6170,11/02/2021 06:57:22,11/02/2021 06:57:24,11/02/2021 07:20:04,11/02/2021 07:20:06,55812,57064,1252,22
6143,11/02/2021 09:48:24,11/02/2021 09:48:28,11/02/2021 10:34:24,11/02/2021 10:34:34,1257325,1259893,2568,46
6142,11/02/2021 10:14:36,11/02/2021 10:14:40,11/02/2021 18:37:36,11/02/2021 19:47:35,518757,547430,28673,572
6189,11/02/2021 15:41:39,11/02/2021 15:41:41,12/02/2021 06:48:30,12/02/2021 06:48:32,275130460,275161570,31110,906
6175,11/02/2021 19:13:26,11/02/2021 19:13:31,12/02/2021 02:57:57,12/02/2021 07:58:19,275092468,275119047,26579,764
6112,11/02/2021 13:09:46,11/02/2021 13:09:47,12/02/2021 10:09:53,12/02/2021 10:10:04,141817,217466,75649,1260
6136,12/02/2021 15:26:00,12/02/2021 15:26:02,12/02/2021 18:47:50,12/02/2021 18:47:52,1300346,1311630,11284,201
6182,12/02/2021 18:33:23,12/02/2021 18:33:28,12/02/2021 23:58:26,13/02/2021 06:57:36,273216810,273232018,15208,744
6189,12/02/2021 18:16:41,12/02/2021 18:16:43,13/02/2021 08:59:32,13/02/2021 08:59:34,275161593,275195022,33429,882
6143,13/02/2021 09:54:55,13/02/2021 09:54:59,13/02/2021 15:50:10,13/02/2021 15:50:16,1260002,1281213,21211,355
6147,13/02/2021 10:21:00,13/02/2021 10:21:04,13/02/2021 14:11:58,13/02/2021 14:31:07,281686,289995,8309,250
6187,13/02/2021 10:13:39,13/02/2021 10:13:40,13/02/2021 11:15:57,13/02/2021 11:16:00,37916,41288,3372,62
6148,13/02/2021 14:04:03,13/02/2021 14:04:06,13/02/2021 14:50:26,13/02/2021 14:51:43,122578,125115,2537,47
6151,12/02/2021 17:07:24,12/02/2021 17:07:32,13/02/2021 21:25:50,13/02/2021 21:25:52,101830423,101929536,99113,1698
6136,13/02/2021 21:14:19,13/02/2021 21:14:20,13/02/2021 22:45:06,13/02/2021 22:45:30,1311700,1316496,4796,91
6151,14/02/2021 13:00:59,14/02/2021 13:01:06,14/02/2021 19:16:35,14/02/2021 20:05:25,101929583,101950477,20894,424
6189,14/02/2021 12:32:15,14/02/2021 12:32:17,14/02/2021 15:38:42,14/02/2021 15:38:44,275195077,275205398,10321,186
6189,14/02/2021 16:55:39,14/02/2021 16:55:41,15/02/2021 00:06:55,15/02/2021 07:10:43,275205401,275226772,21371,855
6155,14/02/2021 10:32:33,14/02/2021 10:32:34,15/02/2021 02:30:43,15/02/2021 08:15:42,96,53713,53617,1303
6155,14/02/2021 10:32:33,14/02/2021 10:32:34,15/02/2021 02:30:43,15/02/2021 08:15:42,96,53713,53617,1303
6184,14/02/2021 17:31:49,14/02/2021 17:31:50,15/02/2021 07:01:20,15/02/2021 09:12:14,463680,510269,46589,940
6189,15/02/2021 17:19:35,15/02/2021 17:19:37,16/02/2021 06:49:32,16/02/2021 06:49:34,275226792,275262801,36009,809
6109,16/02/2021 22:24:35,16/02/2021 22:24:36,17/02/2021 02:07:12,17/02/2021 05:53:05,74884,82075,7191,448
6189,16/02/2021 16:44:37,16/02/2021 16:44:39,17/02/2021 06:15:54,17/02/2021 06:15:56,275262820,275291590,28770,811
6104,16/02/2021 19:32:32,16/02/2021 19:32:36,16/02/2021 23:23:14,17/02/2021 06:34:32,256914,267986,11072,662
6118,17/02/2021 10:54:03,17/02/2021 10:54:06,17/02/2021 14:26:28,17/02/2021 15:56:17,2258835,2266665,7830,302
6189,17/02/2021 15:51:44,17/02/2021 15:51:46,17/02/2021 17:02:28,17/02/2021 17:02:30,275291610,275295530,3920,70
6189,17/02/2021 17:13:05,17/02/2021 17:13:07,18/02/2021 07:24:46,18/02/2021 07:24:48,275295531,275323548,28017,851
6118,18/02/2021 08:29:43,18/02/2021 08:29:56,18/02/2021 14:09:23,18/02/2021 14:09:47,2266699,2286547,19848,340
6123,18/02/2021 14:26:18,18/02/2021 14:26:20,18/02/2021 17:44:12,18/02/2021 17:44:21,68705,80656,11951,198
6106,18/02/2021 12:00:32,18/02/2021 12:00:39,18/02/2021 14:08:46,18/02/2021 14:53:58,76100,82700,6600,173
6192,18/02/2021 08:18:32,18/02/2021 08:18:33,18/02/2021 15:08:09,18/02/2021 17:20:00,445,23522,23077,541
6189,18/02/2021 18:04:45,18/02/2021 18:04:47,19/02/2021 06:37:37,19/02/2021 06:37:39,275323570,275353646,30076,752
6107,19/02/2021 12:37:53,19/02/2021 12:37:54,19/02/2021 12:37:55,19/02/2021 12:40:49,79965,79965,0,2
6107,19/02/2021 12:42:05,19/02/2021 12:42:06,19/02/2021 12:42:07,19/02/2021 12:43:25,79965,79965,0,1
6143,19/02/2021 14:06:17,19/02/2021 14:06:21,19/02/2021 19:22:16,19/02/2021 19:22:23,1281508,1300403,18895,316
6109,19/02/2021 19:42:10,19/02/2021 19:42:11,20/02/2021 00:42:05,20/02/2021 08:34:40,82259,90770,8511,772
6118,19/02/2021 20:49:17,19/02/2021 20:49:27,20/02/2021 06:56:45,20/02/2021 08:15:33,2286615,2321665,35050,686
6109,19/02/2021 19:42:10,19/02/2021 19:42:11,20/02/2021 00:42:05,20/02/2021 08:34:40,82259,90770,8511,772
6109,19/02/2021 19:42:10,19/02/2021 19:42:11,20/02/2021 00:42:05,20/02/2021 08:34:40,82259,90770,8511,772
6143,20/02/2021 09:39:23,20/02/2021 09:39:27,20/02/2021 13:36:57,20/02/2021 14:05:24,1300432,1314259,13827,266
6189,19/02/2021 16:33:42,19/02/2021 16:33:44,20/02/2021 03:13:44,20/02/2021 09:50:16,275353665,275386678,33013,1036
6109,21/02/2021 15:30:09,21/02/2021 15:30:10,21/02/2021 18:28:11,21/02/2021 19:48:33,90863,98949,8086,258
6106,21/02/2021 14:22:35,21/02/2021 14:22:40,21/02/2021 16:27:47,21/02/2021 16:35:34,82889,89398,6509,132
6172,21/02/2021 20:41:41,21/02/2021 20:41:42,21/02/2021 21:34:49,21/02/2021 21:34:51,304571387,304574492,3105,53
6189,21/02/2021 17:01:25,21/02/2021 17:01:28,21/02/2021 22:02:20,22/02/2021 06:29:45,275386738,275400993,14255,808
6189,22/02/2021 17:30:51,22/02/2021 17:30:51,22/02/2021 17:30:51,22/02/2021 17:30:53,275401015,275401015,0,0
6155,22/02/2021 16:17:42,22/02/2021 16:17:44,22/02/2021 19:32:51,22/02/2021 19:32:53,54117,57727,3610,195
6189,22/02/2021 17:31:08,22/02/2021 17:31:10,23/02/2021 07:04:48,23/02/2021 07:04:50,275401015,275428334,27319,813
6189,22/02/2021 17:31:08,22/02/2021 17:31:10,23/02/2021 07:04:48,23/02/2021 07:04:50,275401015,275428334,27319,813
6189,22/02/2021 17:31:08,22/02/2021 17:31:10,23/02/2021 07:04:48,23/02/2021 07:04:50,275401015,275428334,27319,813
6189,22/02/2021 17:31:08,22/02/2021 17:31:10,23/02/2021 07:04:48,23/02/2021 07:04:50,275401015,275428334,27319,813
6189,22/02/2021 17:31:08,22/02/2021 17:31:10,23/02/2021 07:04:48,23/02/2021 07:04:50,275401015,275428334,27319,813
6189,22/02/2021 17:31:08,22/02/2021 17:31:10,23/02/2021 07:04:48,23/02/2021 07:04:50,275401015,275428334,27319,813
6189,22/02/2021 17:31:08,22/02/2021 17:31:10,23/02/2021 07:04:48,23/02/2021 07:04:50,275401015,275428334,27319,813
6189,22/02/2021 17:31:08,22/02/2021 17:31:10,23/02/2021 07:04:48,23/02/2021 07:04:50,275401015,275428334,27319,813
6189,22/02/2021 17:31:08,22/02/2021 17:31:10,23/02/2021 07:04:48,23/02/2021 07:04:50,275401015,275428334,27319,813
6189,22/02/2021 17:31:08,22/02/2021 17:31:10,23/02/2021 07:04:48,23/02/2021 07:04:50,275401015,275428334,27319,813
6189,22/02/2021 17:31:08,22/02/2021 17:31:10,23/02/2021 07:04:48,23/02/2021 07:04:50,275401015,275428334,27319,813
6189,22/02/2021 17:31:08,22/02/2021 17:31:10,23/02/2021 07:04:48,23/02/2021 07:04:50,275401015,275428334,27319,813
6189,22/02/2021 17:31:08,22/02/2021 17:31:10,23/02/2021 07:04:48,23/02/2021 07:04:50,275401015,275428334,27319,813
6189,22/02/2021 17:31:08,22/02/2021 17:31:10,23/02/2021 07:04:48,23/02/2021 07:04:50,275401015,275428334,27319,813
6189,22/02/2021 17:31:08,22/02/2021 17:31:10,23/02/2021 07:04:48,23/02/2021 07:04:50,275401015,275428334,27319,813
6189,22/02/2021 17:31:08,22/02/2021 17:31:10,23/02/2021 07:04:48,23/02/2021 07:04:50,275401015,275428334,27319,813
6118,28/12/2020 13:13:03,28/12/2020 13:13:06,28/12/2020 16:51:57,28/12/2020 17:29:10,1983462,1991701,8239,256
6189,22/02/2021 17:31:08,22/02/2021 17:31:10,23/02/2021 07:04:48,23/02/2021 07:04:50,275401015,275428334,27319,813
6153,23/02/2021 16:20:05,23/02/2021 16:20:09,23/02/2021 20:25:20,23/02/2021 20:37:06,282676240,282686784,10544,257
6189,23/02/2021 16:08:40,23/02/2021 16:08:42,24/02/2021 06:12:18,24/02/2021 06:12:20,275428351,275453311,24960,843
6147,24/02/2021 09:05:02,24/02/2021 09:05:05,24/02/2021 12:20:07,24/02/2021 13:35:36,290686,298907,8221,270
6111,24/02/2021 11:09:31,24/02/2021 11:09:36,24/02/2021 12:10:04,24/02/2021 12:11:29,106435,108211,1776,61
6183,24/02/2021 16:32:35,24/02/2021 16:32:53,24/02/2021 22:48:14,24/02/2021 22:48:18,304591516,304614070,22554,375
6183,24/02/2021 16:32:35,24/02/2021 16:32:53,24/02/2021 22:48:14,24/02/2021 22:48:18,304591516,304614070,22554,375
6183,24/02/2021 16:32:35,24/02/2021 16:32:53,24/02/2021 22:48:14,24/02/2021 22:48:18,304591516,304614070,22554,375
6189,24/02/2021 16:55:13,24/02/2021 16:55:16,25/02/2021 07:01:50,25/02/2021 07:01:52,275453332,275477936,24604,846
6143,25/02/2021 12:22:44,25/02/2021 12:22:48,25/02/2021 13:27:10,25/02/2021 13:27:22,1314530,1318345,3815,64
6142,25/02/2021 09:59:22,25/02/2021 09:59:23,25/02/2021 12:41:47,25/02/2021 12:41:58,548240,557090,8850,162
6151,24/02/2021 21:12:33,24/02/2021 21:12:34,25/02/2021 12:53:12,25/02/2021 12:53:32,101951167,102004884,53717,940
6189,25/02/2021 13:35:14,25/02/2021 13:35:15,25/02/2021 17:31:08,25/02/2021 17:31:14,275477949,275492046,14097,236
6116,25/02/2021 12:41:33,25/02/2021 12:41:34,25/02/2021 16:08:29,25/02/2021 16:08:52,426162,439188,13026,207
6150,25/02/2021 14:58:53,25/02/2021 14:58:55,25/02/2021 19:37:26,25/02/2021 19:37:28,135474,151787,16313,278
6184,25/02/2021 20:41:06,25/02/2021 20:41:10,26/02/2021 05:24:29,26/02/2021 07:46:21,510790,541624,30834,665
6132,25/02/2021 18:21:43,25/02/2021 18:21:46,25/02/2021 21:27:05,25/02/2021 21:27:13,3217181,3225460,8279,185
6136,25/02/2021 12:57:10,25/02/2021 12:57:16,25/02/2021 20:31:41,25/02/2021 23:06:21,1317125,1344190,27065,609
6189,25/02/2021 17:57:30,25/02/2021 17:57:32,26/02/2021 06:49:36,26/02/2021 06:49:38,275492046,275516383,24337,772
6107,26/02/2021 12:10:09,26/02/2021 12:10:11,26/02/2021 17:45:17,26/02/2021 18:11:12,80350,102118,21768,361
6132,26/02/2021 15:10:05,26/02/2021 15:10:09,26/02/2021 18:39:12,26/02/2021 19:26:59,3225496,3234076,8580,256
6189,26/02/2021 17:13:06,26/02/2021 17:13:08,27/02/2021 02:07:49,27/02/2021 09:01:58,275516404,275543637,27233,948
6143,27/02/2021 13:31:32,27/02/2021 13:31:37,27/02/2021 20:00:59,27/02/2021 20:01:04,1318462,1341954,23492,389
6120,27/02/2021 15:14:57,27/02/2021 15:14:58,27/02/2021 16:08:10,27/02/2021 16:08:14,640994,644488,3494,53
6109,28/02/2021 09:07:17,28/02/2021 09:07:19,28/02/2021 09:07:52,28/02/2021 09:07:52,99406,99418,12,0
6109,28/02/2021 09:08:19,28/02/2021 09:08:20,28/02/2021 12:52:42,28/02/2021 12:52:52,99418,106285,6867,224
6109,28/02/2021 23:20:15,28/02/2021 23:20:16,01/03/2021 07:27:21,01/03/2021 07:27:34,106316,113282,6966,487
6189,28/02/2021 17:17:27,28/02/2021 17:17:28,01/03/2021 06:55:40,01/03/2021 06:55:42,275543701,275553988,10287,818
6109,01/03/2021 08:28:19,01/03/2021 08:28:20,01/03/2021 10:33:52,01/03/2021 10:33:58,113285,119198,5913,125
6109,01/03/2021 13:28:44,01/03/2021 13:28:45,01/03/2021 15:42:46,01/03/2021 15:43:01,119207,126345,7138,134
6109,01/03/2021 18:53:34,01/03/2021 18:53:35,01/03/2021 19:29:07,01/03/2021 19:29:21,126354,128481,2127,35
6109,01/03/2021 21:02:14,01/03/2021 21:02:15,02/03/2021 00:41:47,02/03/2021 07:26:02,128486,136485,7999,623
6186,01/03/2021 09:38:16,01/03/2021 09:38:17,01/03/2021 18:11:31,01/03/2021 21:52:41,273026556,273057659,31103,734
6189,01/03/2021 16:37:59,01/03/2021 16:38:01,02/03/2021 06:32:48,02/03/2021 06:32:50,275554007,275579833,25826,834
6109,02/03/2021 08:43:25,02/03/2021 08:46:33,02/03/2021 10:42:41,02/03/2021 11:03:57,136490,142130,5640,140
6118,02/03/2021 09:39:34,02/03/2021 09:39:38,02/03/2021 13:04:02,02/03/2021 16:07:56,2327321,2335042,7721,388
6109,02/03/2021 13:23:00,02/03/2021 13:23:01,02/03/2021 15:37:56,02/03/2021 15:38:01,142139,150109,7970,135
6119,02/03/2021 14:09:02,02/03/2021 14:09:03,02/03/2021 17:48:12,02/03/2021 17:48:17,768559,780811,12252,219
6139,02/03/2021 18:28:17,02/03/2021 18:28:19,02/03/2021 19:20:33,02/03/2021 19:20:35,277974,280905,2931,52
6139,02/03/2021 18:28:17,02/03/2021 18:28:19,02/03/2021 19:20:33,02/03/2021 19:20:35,277974,280905,2931,52
6109,02/03/2021 19:22:02,02/03/2021 19:22:03,02/03/2021 21:30:07,02/03/2021 21:30:18,150120,156211,6091,128
6139,02/03/2021 18:28:17,02/03/2021 18:28:19,02/03/2021 19:20:33,02/03/2021 19:20:35,277974,280905,2931,52
6189,02/03/2021 16:08:14,02/03/2021 16:08:16,03/03/2021 06:34:49,03/03/2021 06:34:51,275579852,275607713,27861,866
6189,02/03/2021 16:08:14,02/03/2021 16:08:16,03/03/2021 06:34:49,03/03/2021 06:34:51,275579852,275607713,27861,866
6118,02/03/2021 22:49:30,02/03/2021 22:49:48,03/03/2021 07:31:30,03/03/2021 07:31:35,2335051,2365496,30445,522
6170,03/03/2021 09:40:04,03/03/2021 09:40:05,03/03/2021 11:49:26,03/03/2021 11:49:32,57999,65451,7452,129
6193,03/03/2021 09:30:07,03/03/2021 09:30:11,03/03/2021 11:45:04,03/03/2021 12:53:11,336990,344203,7213,203
6172,03/03/2021 16:03:13,03/03/2021 16:03:14,03/03/2021 20:55:22,03/03/2021 20:55:49,304574953,304592885,17932,292
6151,03/03/2021 17:34:54,03/03/2021 17:34:56,03/03/2021 17:35:11,03/03/2021 17:35:13,102005321,102005330,9,0
6151,03/03/2021 17:35:23,03/03/2021 17:35:25,03/03/2021 18:16:45,03/03/2021 18:19:42,102005330,102007675,2345,44
6144,03/03/2021 19:45:18,03/03/2021 19:45:22,04/03/2021 01:45:12,04/03/2021 07:57:23,188684,207433,18749,732
6189,03/03/2021 15:21:07,03/03/2021 15:21:08,04/03/2021 06:40:16,04/03/2021 06:40:18,275607731,275634657,26926,919
6189,04/03/2021 16:35:09,04/03/2021 16:35:11,05/03/2021 06:21:00,05/03/2021 06:21:02,275634676,275667741,33065,825
6184,04/03/2021 13:20:01,04/03/2021 13:20:03,05/03/2021 04:46:44,05/03/2021 09:12:01,541949,595014,53065,1192
6112,05/03/2021 08:05:57,05/03/2021 08:06:00,05/03/2021 11:19:45,05/03/2021 11:19:49,218783,230477,11694,193
6107,05/03/2021 15:34:15,05/03/2021 15:34:17,05/03/2021 15:47:46,05/03/2021 15:48:25,102525,103290,765,14
6189,05/03/2021 15:55:32,05/03/2021 15:55:34,05/03/2021 17:25:33,05/03/2021 17:25:35,275667760,275672771,5011,90
6175,05/03/2021 17:40:26,05/03/2021 17:40:30,05/03/2021 19:49:18,05/03/2021 19:50:16,275120072,275127668,7596,129
6186,05/03/2021 12:25:45,05/03/2021 12:25:47,05/03/2021 18:18:37,05/03/2021 18:18:50,273057835,273079233,21398,353
6184,05/03/2021 22:25:32,05/03/2021 22:25:37,06/03/2021 07:56:54,06/03/2021 08:33:16,595043,626420,31377,607
6143,06/03/2021 09:31:37,06/03/2021 09:31:41,06/03/2021 18:55:54,06/03/2021 18:56:19,1342295,1375469,33174,564
6189,05/03/2021 17:54:25,05/03/2021 17:54:27,06/03/2021 02:13:54,06/03/2021 10:03:03,275672772,275698078,25306,968
6107,05/03/2021 19:08:37,05/03/2021 19:08:39,06/03/2021 10:31:08,06/03/2021 10:31:20,103299,155908,52609,922
6104,06/03/2021 13:41:50,06/03/2021 13:41:58,06/03/2021 14:08:15,06/03/2021 14:08:17,269237,270768,1531,26
6177,06/03/2021 16:39:17,06/03/2021 16:39:19,06/03/2021 19:05:25,06/03/2021 19:05:43,65725,74367,8642,146
6179,06/03/2021 11:41:03,06/03/2021 11:41:04,07/03/2021 00:04:20,07/03/2021 00:04:24,274691277,274737482,46205,743
6109,07/03/2021 08:16:59,07/03/2021 08:17:00,07/03/2021 09:29:44,07/03/2021 09:29:49,156511,158486,1975,72
6109,07/03/2021 10:15:08,07/03/2021 10:15:09,07/03/2021 12:59:40,07/03/2021 14:20:32,158488,167058,8570,245
6109,07/03/2021 10:15:08,07/03/2021 10:15:09,07/03/2021 12:59:40,07/03/2021 14:20:32,158488,167058,8570,245
6109,07/03/2021 10:15:08,07/03/2021 10:15:09,07/03/2021 12:59:40,07/03/2021 14:20:32,158488,167058,8570,245
6109,07/03/2021 15:22:34,07/03/2021 15:22:36,07/03/2021 17:31:50,07/03/2021 17:35:04,167061,172492,5431,132
6109,07/03/2021 15:22:34,07/03/2021 15:22:36,07/03/2021 17:31:50,07/03/2021 17:35:04,167061,172492,5431,132
6151,06/03/2021 21:38:02,06/03/2021 21:38:03,07/03/2021 17:35:34,07/03/2021 17:37:22,102007896,102077135,69239,1199
6109,07/03/2021 15:22:34,07/03/2021 15:22:36,07/03/2021 17:31:50,07/03/2021 17:35:04,167061,172492,5431,132
6147,08/03/2021 12:00:03,08/03/2021 12:00:06,08/03/2021 15:25:44,08/03/2021 16:35:23,299695,308160,8465,275
6169,08/03/2021 10:40:26,08/03/2021 10:40:27,08/03/2021 13:49:19,08/03/2021 13:50:10,273308543,273317481,8938,189
6153,08/03/2021 17:14:14,08/03/2021 17:14:17,08/03/2021 21:08:09,08/03/2021 21:11:03,282687406,282697664,10258,236
6183,08/03/2021 17:35:43,08/03/2021 17:36:23,09/03/2021 01:09:09,09/03/2021 07:34:41,304614673,304641684,27011,838
6109,08/03/2021 17:51:19,08/03/2021 17:51:20,08/03/2021 19:53:42,08/03/2021 22:22:23,172560,178374,5814,271
6168,08/03/2021 18:52:34,08/03/2021 18:52:35,08/03/2021 21:16:04,08/03/2021 21:16:06,273726664,273735264,8600,143
6123,08/03/2021 20:02:43,08/03/2021 20:02:48,08/03/2021 22:19:14,08/03/2021 22:19:22,81696,89166,7470,136
6189,08/03/2021 12:22:12,08/03/2021 12:22:14,09/03/2021 06:14:33,09/03/2021 06:14:35,275698179,275722336,24157,1072
6118,09/03/2021 09:30:12,09/03/2021 09:30:22,09/03/2021 11:45:02,09/03/2021 11:45:19,2365705,2373535,7830,135
6116,09/03/2021 12:52:12,09/03/2021 12:52:16,09/03/2021 13:15:44,09/03/2021 13:16:02,439763,441213,1450,23
6119,09/03/2021 10:47:33,09/03/2021 10:47:43,09/03/2021 14:18:41,09/03/2021 14:18:47,781261,793254,11993,211
6175,09/03/2021 16:41:26,09/03/2021 16:41:30,09/03/2021 23:12:26,10/03/2021 07:30:34,275127854,275147013,19159,889
6106,09/03/2021 11:01:30,09/03/2021 11:01:36,09/03/2021 13:06:07,09/03/2021 16:44:36,90409,96804,6395,343
6139,09/03/2021 20:12:20,09/03/2021 20:12:22,09/03/2021 22:02:28,09/03/2021 22:02:40,281405,288205,6800,110
6189,09/03/2021 17:02:22,09/03/2021 17:02:24,10/03/2021 05:26:52,10/03/2021 05:26:55,275722357,275749494,27137,744
6118,10/03/2021 09:59:43,10/03/2021 09:59:46,10/03/2021 13:26:03,10/03/2021 14:00:42,2373585,2382006,8421,240
6109,10/03/2021 17:05:55,10/03/2021 17:05:56,10/03/2021 19:05:05,10/03/2021 19:15:56,178495,184754,6259,130
6136,10/03/2021 18:26:35,10/03/2021 18:26:41,11/03/2021 00:26:19,11/03/2021 07:17:32,1352862,1374885,22023,770
6155,10/03/2021 17:38:46,10/03/2021 17:38:47,10/03/2021 22:06:10,10/03/2021 22:06:12,58528,63579,5051,267
6189,10/03/2021 19:28:58,10/03/2021 19:28:59,11/03/2021 05:13:42,11/03/2021 05:13:44,275749522,275780049,30527,584
6107,10/03/2021 12:49:50,10/03/2021 12:49:52,11/03/2021 07:50:33,11/03/2021 07:50:45,156153,222433,66280,1140
6136,11/03/2021 08:45:58,11/03/2021 08:46:03,11/03/2021 10:55:17,11/03/2021 12:10:53,1374889,1381554,6665,204
6136,11/03/2021 08:45:58,11/03/2021 08:46:03,11/03/2021 10:55:17,11/03/2021 12:10:53,1374889,1381554,6665,204
6136,11/03/2021 08:45:58,11/03/2021 08:46:03,11/03/2021 10:55:17,11/03/2021 12:10:53,1374889,1381554,6665,204
6193,11/03/2021 09:28:59,11/03/2021 09:29:03,11/03/2021 11:42:01,11/03/2021 14:29:52,344585,351764,7179,300
6109,11/03/2021 18:20:21,11/03/2021 18:20:22,11/03/2021 20:06:47,11/03/2021 20:06:52,184822,188698,3876,106
6189,11/03/2021 16:32:17,11/03/2021 16:32:19,12/03/2021 06:10:57,12/03/2021 06:10:59,275780072,275806490,26418,818
6151,11/03/2021 16:53:10,11/03/2021 16:53:11,12/03/2021 07:38:31,12/03/2021 07:38:47,102077327,102129609,52282,885
6147,12/03/2021 08:38:16,12/03/2021 08:38:20,12/03/2021 11:31:56,12/03/2021 13:28:39,308404,314634,6230,290
6123,12/03/2021 13:22:27,12/03/2021 13:22:28,12/03/2021 15:53:26,12/03/2021 15:57:38,89383,98525,9142,155
6138,12/03/2021 14:33:12,12/03/2021 14:33:18,12/03/2021 16:39:15,12/03/2021 17:02:26,6893,13402,6509,149
6109,12/03/2021 17:40:57,12/03/2021 17:40:58,12/03/2021 19:51:39,12/03/2021 20:26:16,188759,195406,6647,165
6109,12/03/2021 17:40:57,12/03/2021 17:40:58,12/03/2021 19:51:39,12/03/2021 20:26:16,188759,195406,6647,165
6118,12/03/2021 16:54:08,12/03/2021 16:54:16,12/03/2021 20:06:37,12/03/2021 21:24:59,2382109,2392840,10731,270
6118,12/03/2021 16:54:08,12/03/2021 16:54:16,12/03/2021 20:06:37,12/03/2021 21:24:59,2382109,2392840,10731,270
6118,12/03/2021 16:54:08,12/03/2021 16:54:16,12/03/2021 20:06:37,12/03/2021 21:24:59,2382109,2392840,10731,270
6189,12/03/2021 16:43:39,12/03/2021 16:43:43,13/03/2021 00:33:54,13/03/2021 09:11:21,275806511,275830417,23906,987
6119,12/03/2021 16:00:38,12/03/2021 16:00:39,13/03/2021 00:52:42,13/03/2021 10:46:45,793456,805940,12484,1126
6123,13/03/2021 11:04:55,13/03/2021 11:04:57,13/03/2021 14:40:56,13/03/2021 14:56:01,98574,111694,13120,231
6139,12/03/2021 17:30:19,12/03/2021 17:30:21,13/03/2021 11:47:19,13/03/2021 15:02:27,288404,352731,64327,1292
6119,13/03/2021 13:08:19,13/03/2021 13:08:20,13/03/2021 17:00:26,13/03/2021 17:00:30,805947,816504,10557,232
6139,13/03/2021 17:36:17,13/03/2021 17:36:19,13/03/2021 21:03:55,13/03/2021 21:09:07,352739,365517,12778,212
6143,14/03/2021 10:10:38,14/03/2021 10:10:42,14/03/2021 20:11:04,14/03/2021 20:11:06,1375876,1411531,35655,600
6173,14/03/2021 13:41:13,14/03/2021 13:41:17,14/03/2021 15:03:19,14/03/2021 15:04:30,281977728,281982275,4547,83
6100,14/03/2021 14:40:26,14/03/2021 14:40:31,14/03/2021 17:28:40,14/03/2021 17:28:43,331486,339579,8093,168
6189,14/03/2021 17:32:03,14/03/2021 17:32:05,15/03/2021 06:30:39,15/03/2021 06:30:41,275830481,275846543,16062,778
6151,14/03/2021 19:10:10,14/03/2021 19:10:11,15/03/2021 07:46:02,15/03/2021 07:46:50,102149339,102192236,42897,756
6193,15/03/2021 09:10:29,15/03/2021 09:10:33,15/03/2021 11:24:36,15/03/2021 14:56:58,351949,359135,7186,346
6118,15/03/2021 09:41:39,15/03/2021 09:41:41,15/03/2021 18:29:28,15/03/2021 18:29:47,2392924,2424024,31100,528
6109,15/03/2021 20:55:20,15/03/2021 20:55:21,15/03/2021 23:25:42,15/03/2021 23:25:48,195611,204350,8739,150
6118,15/03/2021 20:51:23,15/03/2021 20:51:24,16/03/2021 03:57:11,16/03/2021 05:38:33,2424029,2451513,27484,527
6189,15/03/2021 16:17:22,15/03/2021 16:17:23,16/03/2021 06:10:06,16/03/2021 06:10:08,275846562,275870113,23551,832
6133,15/03/2021 18:12:38,15/03/2021 18:12:39,16/03/2021 06:42:28,16/03/2021 08:59:15,447836,491541,43705,886
6133,15/03/2021 18:12:38,15/03/2021 18:12:39,16/03/2021 06:42:28,16/03/2021 08:59:15,447836,491541,43705,886
6133,15/03/2021 18:12:38,15/03/2021 18:12:39,16/03/2021 06:42:28,16/03/2021 08:59:15,447836,491541,43705,886
6138,16/03/2021 09:32:05,16/03/2021 09:32:11,16/03/2021 11:40:55,16/03/2021 15:26:04,13586,20149,6563,353
6143,16/03/2021 15:45:08,16/03/2021 15:45:13,16/03/2021 18:18:15,16/03/2021 18:18:23,1411623,1420613,8990,153
6101,16/03/2021 16:32:49,16/03/2021 16:32:55,16/03/2021 17:44:45,16/03/2021 17:44:51,203491,207327,3836,72
6155,16/03/2021 17:37:16,16/03/2021 17:37:17,16/03/2021 19:45:30,16/03/2021 19:55:12,63862,66243,2381,137
6189,16/03/2021 17:06:29,16/03/2021 17:06:31,17/03/2021 00:11:54,17/03/2021 07:31:12,275870135,275891280,21145,864
6147,17/03/2021 08:46:21,17/03/2021 08:46:24,17/03/2021 12:12:41,17/03/2021 13:49:59,314950,323420,8470,303
6118,17/03/2021 10:01:10,17/03/2021 10:01:21,17/03/2021 14:43:52,17/03/2021 15:14:01,2451555,2467312,15757,312
6123,17/03/2021 11:10:46,17/03/2021 11:10:47,17/03/2021 11:14:31,17/03/2021 11:14:48,111922,112141,219,4
6123,17/03/2021 11:15:31,17/03/2021 11:15:32,17/03/2021 14:33:41,17/03/2021 17:09:23,112141,124197,12056,353
6186,17/03/2021 14:08:38,17/03/2021 14:08:39,17/03/2021 15:45:25,17/03/2021 15:45:33,273079811,273085631,5820,96
6189,17/03/2021 15:35:49,17/03/2021 15:35:51,17/03/2021 15:48:50,17/03/2021 15:48:52,275891296,275892013,717,13
6151,17/03/2021 16:22:59,17/03/2021 16:23:01,17/03/2021 17:55:19,17/03/2021 17:55:21,102192402,102197656,5254,92
6116,17/03/2021 16:36:46,17/03/2021 16:36:47,17/03/2021 20:01:51,17/03/2021 20:22:35,441606,454463,12857,225
6189,17/03/2021 16:57:04,17/03/2021 16:57:06,18/03/2021 06:15:35,18/03/2021 06:15:37,275892015,275906761,14746,798
6189,17/03/2021 16:57:04,17/03/2021 16:57:06,18/03/2021 06:15:35,18/03/2021 06:15:37,275892015,275906761,14746,798
6189,17/03/2021 16:57:04,17/03/2021 16:57:06,18/03/2021 06:15:35,18/03/2021 06:15:37,275892015,275906761,14746,798
6119,17/03/2021 18:54:59,17/03/2021 18:55:04,17/03/2021 22:31:44,18/03/2021 10:03:38,816773,828919,12146,908
6136,18/03/2021 16:02:46,18/03/2021 16:02:51,19/03/2021 00:13:21,19/03/2021 07:59:27,1381976,1405920,23944,956
6189,18/03/2021 16:27:45,18/03/2021 16:27:46,18/03/2021 16:31:06,18/03/2021 16:31:08,275906781,275906962,181,3
6189,18/03/2021 16:47:38,18/03/2021 16:47:40,19/03/2021 05:55:59,19/03/2021 05:56:01,275906962,275940206,33244,788
6182,18/03/2021 18:50:26,18/03/2021 18:50:31,18/03/2021 23:38:55,19/03/2021 06:31:47,273233834,273247182,13348,701
6101,19/03/2021 07:13:08,19/03/2021 07:13:15,19/03/2021 11:24:26,19/03/2021 11:51:52,207488,220989,13501,278
6151,18/03/2021 17:05:59,18/03/2021 17:06:00,19/03/2021 07:37:57,19/03/2021 07:37:59,102197702,102249134,51432,872
6184,18/03/2021 16:11:14,18/03/2021 16:11:15,19/03/2021 07:44:37,19/03/2021 07:44:52,627063,681136,54073,933
6107,19/03/2021 08:23:09,19/03/2021 08:23:11,19/03/2021 14:01:35,19/03/2021 14:02:07,222910,242278,19368,338
6193,19/03/2021 09:52:28,19/03/2021 09:52:32,19/03/2021 12:07:01,19/03/2021 14:28:22,359320,366542,7222,275
6153,19/03/2021 17:21:42,19/03/2021 17:21:45,19/03/2021 21:01:37,19/03/2021 22:19:00,282698191,282708316,10125,297
6119,19/03/2021 18:58:21,19/03/2021 18:58:24,19/03/2021 22:33:02,19/03/2021 22:33:04,829007,842231,13224,214
6107,19/03/2021 19:52:22,19/03/2021 19:52:24,20/03/2021 07:57:42,20/03/2021 07:57:54,242294,274468,32174,725
6189,19/03/2021 17:51:09,19/03/2021 17:51:11,20/03/2021 03:06:13,20/03/2021 08:49:16,275940230,275968602,28372,898
6132,20/03/2021 09:50:55,20/03/2021 09:50:56,20/03/2021 13:31:39,20/03/2021 13:34:29,3235110,3247420,12310,223
6101,19/03/2021 13:38:01,19/03/2021 13:38:07,19/03/2021 15:42:08,20/03/2021 15:18:30,220994,227576,6582,1540
6139,20/03/2021 17:35:04,20/03/2021 17:35:15,20/03/2021 19:04:34,20/03/2021 19:04:57,365996,371509,5513,89
6168,20/03/2021 18:51:44,20/03/2021 18:51:49,20/03/2021 19:41:31,20/03/2021 19:41:54,273735884,273738680,2796,50
6119,20/03/2021 12:49:48,20/03/2021 12:49:49,20/03/2021 21:21:48,21/03/2021 10:05:29,842271,854478,12207,1275
6148,21/03/2021 18:13:56,21/03/2021 18:13:58,21/03/2021 22:14:15,21/03/2021 22:14:28,127675,141991,14316,240
6104,21/03/2021 10:54:53,21/03/2021 10:54:57,21/03/2021 14:52:12,21/03/2021 18:45:31,271843,283227,11384,470
6189,21/03/2021 18:57:45,21/03/2021 18:57:47,22/03/2021 06:11:51,22/03/2021 06:11:53,275968670,275982667,13997,674
6118,21/03/2021 18:49:59,21/03/2021 18:50:08,22/03/2021 04:43:21,22/03/2021 06:47:48,2467431,2501618,34187,717
6130,21/03/2021 19:31:32,21/03/2021 19:31:33,22/03/2021 07:17:58,22/03/2021 07:18:00,61066,103891,42825,706
6147,22/03/2021 10:22:55,22/03/2021 10:22:58,22/03/2021 13:42:09,22/03/2021 14:43:44,323742,331968,8226,260
6118,22/03/2021 12:41:49,22/03/2021 12:41:57,22/03/2021 16:41:57,22/03/2021 17:09:58,2501633,2515070,13437,268
6189,22/03/2021 16:53:48,22/03/2021 16:53:51,23/03/2021 05:37:25,23/03/2021 05:37:27,275982687,276009766,27079,763
6107,23/03/2021 11:45:19,23/03/2021 11:45:20,23/03/2021 15:27:11,23/03/2021 15:27:25,274656,287976,13320,222
6138,23/03/2021 12:43:03,23/03/2021 12:43:10,23/03/2021 15:49:58,23/03/2021 16:32:01,20497,30652,10155,228
6193,23/03/2021 16:25:31,23/03/2021 16:25:35,23/03/2021 18:39:40,23/03/2021 20:08:55,366742,374016,7274,223
6109,23/03/2021 16:26:15,23/03/2021 16:26:16,23/03/2021 19:06:48,23/03/2021 20:35:20,204879,212592,7713,249
6189,23/03/2021 15:35:56,23/03/2021 15:35:58,24/03/2021 05:49:50,24/03/2021 05:49:52,276009786,276037035,27249,853
6182,23/03/2021 19:11:31,23/03/2021 19:11:36,23/03/2021 23:25:02,24/03/2021 06:22:20,273247432,273258982,11550,670
6184,23/03/2021 16:39:36,23/03/2021 16:39:37,24/03/2021 06:06:29,24/03/2021 07:36:57,681365,726459,45094,897
6101,23/03/2021 18:36:22,23/03/2021 18:36:28,23/03/2021 20:43:07,24/03/2021 09:13:06,227762,234373,6611,876
6143,24/03/2021 11:18:06,24/03/2021 11:18:10,24/03/2021 11:18:23,24/03/2021 11:18:51,1421018,1421020,2,0
6143,24/03/2021 11:19:10,24/03/2021 11:19:15,24/03/2021 11:52:53,24/03/2021 11:52:55,1421020,1423082,2062,33
6143,24/03/2021 18:23:39,24/03/2021 18:23:43,24/03/2021 21:42:02,24/03/2021 21:42:11,1423097,1435114,12017,198
6109,24/03/2021 18:57:43,24/03/2021 18:57:44,24/03/2021 21:22:05,24/03/2021 21:54:10,212655,219160,6505,176
6151,24/03/2021 16:55:02,24/03/2021 16:55:03,25/03/2021 07:39:29,25/03/2021 07:39:40,102249468,102301365,51897,884
6118,24/03/2021 19:03:11,24/03/2021 19:03:12,25/03/2021 09:13:06,25/03/2021 09:13:25,2515172,2565156,49984,850
6148,25/03/2021 09:17:10,25/03/2021 09:17:11,25/03/2021 13:09:56,25/03/2021 13:10:10,142236,156061,13825,233
6138,25/03/2021 11:09:30,25/03/2021 11:09:37,25/03/2021 12:52:38,25/03/2021 12:52:41,52079,57981,5902,103
6118,25/03/2021 15:20:29,25/03/2021 15:20:32,25/03/2021 18:54:10,25/03/2021 20:26:07,2565165,2573479,8314,305
6175,25/03/2021 16:18:50,25/03/2021 16:18:55,25/03/2021 22:49:19,26/03/2021 07:56:23,275147747,275167107,19360,937
6143,25/03/2021 16:54:00,25/03/2021 16:54:04,25/03/2021 19:57:55,25/03/2021 19:58:05,1435159,1446108,10949,184
6138,25/03/2021 14:58:44,25/03/2021 14:58:50,25/03/2021 15:49:58,25/03/2021 16:55:28,57986,60236,2250,116
6103,25/03/2021 12:20:47,25/03/2021 12:20:49,25/03/2021 19:05:23,25/03/2021 19:05:31,132554,158115,25561,404
6172,25/03/2021 20:06:08,25/03/2021 20:06:10,26/03/2021 05:46:09,26/03/2021 06:35:42,304593932,304628813,34881,629
6138,25/03/2021 20:35:29,25/03/2021 20:35:31,26/03/2021 06:35:34,26/03/2021 06:35:37,60245,95053,34808,600
6118,25/03/2021 22:05:57,25/03/2021 22:06:04,26/03/2021 07:22:00,26/03/2021 07:22:12,2573482,2580515,7033,556
6143,26/03/2021 08:26:08,26/03/2021 08:26:16,26/03/2021 09:01:05,26/03/2021 09:01:08,1446134,1447940,1806,35
6189,25/03/2021 14:53:30,25/03/2021 14:53:32,26/03/2021 00:12:47,26/03/2021 09:40:56,276037114,276065864,28750,1127
6118,26/03/2021 08:15:15,26/03/2021 08:15:42,26/03/2021 12:19:07,26/03/2021 12:19:30,2580517,2594757,14240,244
6136,26/03/2021 09:48:21,26/03/2021 09:48:22,26/03/2021 14:55:38,26/03/2021 14:55:55,1406333,1425185,18852,307
6119,26/03/2021 15:53:33,26/03/2021 15:53:35,26/03/2021 18:07:40,26/03/2021 18:07:42,854818,862574,7756,134
6184,26/03/2021 17:50:02,26/03/2021 17:50:07,27/03/2021 02:20:06,27/03/2021 07:43:33,726582,756973,30391,833
6182,26/03/2021 20:42:15,26/03/2021 20:42:19,27/03/2021 02:36:07,27/03/2021 06:46:53,273259121,273276425,17304,604
6118,26/03/2021 22:26:07,26/03/2021 22:26:15,27/03/2021 06:22:50,27/03/2021 08:21:45,2594773,2622088,27315,595
6136,27/03/2021 09:54:20,27/03/2021 09:54:24,27/03/2021 18:13:31,27/03/2021 18:20:06,1425234,1454637,29403,505
6106,27/03/2021 09:19:00,27/03/2021 09:19:07,27/03/2021 13:45:36,27/03/2021 13:46:08,97934,112480,14546,267
6106,27/03/2021 13:46:27,27/03/2021 13:46:36,27/03/2021 14:14:22,27/03/2021 14:28:56,112480,114017,1537,42
6123,27/03/2021 15:41:52,27/03/2021 15:41:53,27/03/2021 20:05:08,27/03/2021 20:17:43,124792,140605,15813,275
6136,27/03/2021 09:54:20,27/03/2021 09:54:24,27/03/2021 18:13:31,27/03/2021 18:20:06,1425234,1454637,29403,505
6136,27/03/2021 09:54:20,27/03/2021 09:54:24,27/03/2021 18:13:31,27/03/2021 18:20:06,1425234,1454637,29403,505
6136,27/03/2021 09:54:20,27/03/2021 09:54:24,27/03/2021 18:13:31,27/03/2021 18:20:06,1425234,1454637,29403,505
6136,27/03/2021 18:26:20,27/03/2021 18:26:24,28/03/2021 00:10:27,28/03/2021 11:17:37,1454637,1475189,20552,1011
6168,27/03/2021 13:31:18,27/03/2021 13:31:19,27/03/2021 18:57:52,27/03/2021 18:58:01,273739035,273749127,10092,326
6132,27/03/2021 13:19:02,27/03/2021 13:19:03,28/03/2021 09:02:31,28/03/2021 09:02:33,3247755,3261261,13506,1183
6188,28/03/2021 14:52:54,28/03/2021 14:52:55,29/03/2021 03:34:47,29/03/2021 08:51:36,274314144,274356491,42347,1078
6109,28/03/2021 16:42:06,28/03/2021 16:42:07,28/03/2021 19:35:56,28/03/2021 20:47:14,219414,227692,8278,245
6136,28/03/2021 13:50:47,28/03/2021 13:50:48,28/03/2021 21:09:32,28/03/2021 21:09:37,1475195,1502124,26929,438
6189,28/03/2021 15:55:06,28/03/2021 15:55:08,29/03/2021 06:06:24,29/03/2021 06:06:26,276065972,276095510,29538,851
6107,28/03/2021 15:40:13,28/03/2021 15:40:14,29/03/2021 00:36:35,29/03/2021 06:58:29,288270,319439,31169,918
6119,29/03/2021 08:12:32,29/03/2021 08:12:34,29/03/2021 13:40:23,29/03/2021 13:40:25,862742,882879,20137,327
6118,28/03/2021 23:51:23,28/03/2021 23:51:27,29/03/2021 00:06:02,29/03/2021 08:47:35,2622134,2623013,879,536
6118,28/03/2021 23:51:23,28/03/2021 23:51:27,29/03/2021 00:06:02,29/03/2021 08:47:35,2622134,2623013,879,536
6118,28/03/2021 23:51:23,28/03/2021 23:51:27,29/03/2021 00:06:02,29/03/2021 08:47:35,2622134,2623013,879,536
6118,28/03/2021 23:51:23,28/03/2021 23:51:27,29/03/2021 00:06:02,29/03/2021 08:47:35,2622134,2623013,879,536
6170,29/03/2021 08:36:07,29/03/2021 08:36:08,29/03/2021 10:52:30,29/03/2021 10:53:07,66590,74404,7814,137
6118,29/03/2021 08:50:16,29/03/2021 08:50:35,29/03/2021 10:59:41,29/03/2021 11:00:15,2623013,2630566,7553,129
6118,29/03/2021 08:50:16,29/03/2021 08:50:35,29/03/2021 10:59:41,29/03/2021 11:00:15,2623013,2630566,7553,129
6118,29/03/2021 08:50:16,29/03/2021 08:50:35,29/03/2021 10:59:41,29/03/2021 11:00:15,2623013,2630566,7553,129
6118,29/03/2021 08:50:16,29/03/2021 08:50:35,29/03/2021 10:59:41,29/03/2021 11:00:15,2623013,2630566,7553,129
6118,29/03/2021 13:32:51,29/03/2021 13:32:59,29/03/2021 16:41:35,29/03/2021 16:41:58,2630571,2640972,10401,189
6193,29/03/2021 08:18:05,29/03/2021 08:18:10,29/03/2021 10:32:10,29/03/2021 13:55:58,374282,381511,7229,337
6139,29/03/2021 08:59:13,29/03/2021 08:59:16,29/03/2021 15:42:22,29/03/2021 15:42:24,372104,396177,24073,403
6119,29/03/2021 15:39:02,29/03/2021 15:39:03,29/03/2021 19:05:56,29/03/2021 20:53:38,882885,895232,12347,314
6189,29/03/2021 19:38:45,29/03/2021 19:38:49,30/03/2021 01:02:23,30/03/2021 05:07:33,276095537,276114305,18768,568
6118,29/03/2021 21:50:39,29/03/2021 21:50:46,30/03/2021 00:06:02,30/03/2021 06:16:32,2640983,2648912,7929,505
6147,30/03/2021 07:32:07,30/03/2021 07:32:10,30/03/2021 10:55:48,30/03/2021 12:00:21,332536,341027,8491,268
6114,29/03/2021 15:57:01,29/03/2021 15:57:03,30/03/2021 05:31:03,30/03/2021 08:58:32,80290,127960,47670,1021
6189,30/03/2021 08:42:33,30/03/2021 08:42:35,30/03/2021 10:33:06,30/03/2021 10:33:08,276114312,276120581,6269,110
6118,30/03/2021 16:06:01,30/03/2021 16:06:08,30/03/2021 20:16:58,30/03/2021 20:43:33,2648926,2664155,15229,277
6137,30/03/2021 16:59:50,30/03/2021 17:01:04,30/03/2021 17:03:42,30/03/2021 17:03:42,99200,99345,145,3
6169,30/03/2021 17:27:46,30/03/2021 17:27:49,30/03/2021 20:16:21,30/03/2021 20:16:21,273318657,273327423,8766,168
6101,30/03/2021 18:16:49,30/03/2021 18:16:50,30/03/2021 18:48:23,30/03/2021 18:48:33,234727,236645,1918,31
6189,30/03/2021 13:15:18,30/03/2021 13:15:22,30/03/2021 20:52:12,30/03/2021 20:52:19,276120587,276147513,26926,457
6101,30/03/2021 20:02:22,30/03/2021 20:02:24,31/03/2021 02:08:06,31/03/2021 05:55:24,236648,257795,21147,593
6101,30/03/2021 20:02:22,30/03/2021 20:02:24,31/03/2021 02:08:06,31/03/2021 05:55:24,236648,257795,21147,593
6132,30/03/2021 17:36:27,30/03/2021 17:36:29,31/03/2021 06:55:20,31/03/2021 06:55:24,3261374,3266470,5096,798
6169,31/03/2021 07:42:05,31/03/2021 07:42:07,31/03/2021 08:21:53,31/03/2021 09:36:22,273327450,273327902,452,114
6148,31/03/2021 07:16:15,31/03/2021 07:16:16,31/03/2021 11:07:59,31/03/2021 11:19:34,156471,169929,13458,243
6193,31/03/2021 08:08:03,31/03/2021 08:08:07,31/03/2021 10:18:02,31/03/2021 12:07:37,381598,388676,7078,239
6189,31/03/2021 11:01:23,31/03/2021 11:01:28,31/03/2021 12:41:48,31/03/2021 12:41:57,276147541,276152901,5360,100
6151,30/03/2021 19:18:00,30/03/2021 19:18:01,31/03/2021 13:21:27,31/03/2021 13:21:29,102301690,102365871,64181,1083
6151,31/03/2021 13:49:43,31/03/2021 13:49:50,31/03/2021 19:57:53,31/03/2021 20:02:18,102365872,102386439,20567,372
6109,31/03/2021 13:05:41,31/03/2021 13:05:42,31/03/2021 14:38:12,31/03/2021 14:38:58,227877,232713,4836,93
6116,31/03/2021 12:19:57,31/03/2021 12:19:59,31/03/2021 15:47:12,31/03/2021 15:54:20,455122,468187,13065,214
6136,31/03/2021 06:38:12,31/03/2021 06:38:13,31/03/2021 16:25:43,31/03/2021 16:25:45,1502266,1535235,32969,587
6139,31/03/2021 17:28:33,31/03/2021 17:28:33,31/03/2021 17:28:33,31/03/2021 17:28:51,396323,396323,0,0
6139,31/03/2021 17:30:39,31/03/2021 17:30:54,31/03/2021 20:59:05,31/03/2021 21:04:17,396324,409172,12848,213
6139,31/03/2021 17:30:39,31/03/2021 17:30:54,31/03/2021 20:59:05,31/03/2021 21:04:17,396324,409172,12848,213
6139,31/03/2021 17:30:39,31/03/2021 17:30:54,31/03/2021 20:59:05,31/03/2021 21:04:17,396324,409172,12848,213
6139,31/03/2021 17:30:39,31/03/2021 17:30:54,31/03/2021 20:59:05,31/03/2021 21:04:17,396324,409172,12848,213
6189,31/03/2021 14:30:34,31/03/2021 14:30:35,01/04/2021 05:24:26,01/04/2021 05:24:28,276152905,276185181,32276,893
6104,31/03/2021 18:14:42,31/03/2021 18:14:46,31/03/2021 23:36:51,01/04/2021 05:31:00,283946,301778,17832,676
6169,01/04/2021 07:49:41,01/04/2021 07:49:43,01/04/2021 12:59:59,01/04/2021 17:14:47,273327952,273342369,14417,565
6188,01/04/2021 10:32:02,01/04/2021 10:32:06,01/04/2021 13:36:09,01/04/2021 13:36:14,274356670,274365586,8916,184
6189,01/04/2021 14:37:22,01/04/2021 14:37:34,01/04/2021 14:37:55,01/04/2021 14:37:57,276185199,276185214,15,0
6118,01/04/2021 16:07:40,01/04/2021 16:08:02,01/04/2021 19:16:37,01/04/2021 19:26:22,2664213,2672596,8383,198
6101,01/04/2021 16:57:53,01/04/2021 16:57:55,02/04/2021 05:48:25,02/04/2021 05:48:29,257888,302350,44462,770
6189,01/04/2021 14:39:03,01/04/2021 14:39:05,02/04/2021 07:50:19,02/04/2021 07:50:21,276185214,276211340,26126,1031
6109,01/04/2021 21:39:31,01/04/2021 21:39:32,02/04/2021 00:49:57,02/04/2021 09:16:56,232802,240746,7944,697
6123,02/04/2021 09:34:09,02/04/2021 09:34:10,02/04/2021 12:48:45,02/04/2021 12:49:10,140935,152712,11777,195
6187,02/04/2021 10:34:48,02/04/2021 10:34:49,02/04/2021 12:41:15,02/04/2021 12:41:20,43774,51108,7334,126
6104,02/04/2021 07:33:17,02/04/2021 07:33:20,02/04/2021 12:44:44,02/04/2021 13:02:24,301857,310879,9022,329
6155,02/04/2021 13:01:30,02/04/2021 13:01:35,02/04/2021 13:06:58,02/04/2021 13:07:34,67059,67357,298,6
6109,02/04/2021 11:36:43,02/04/2021 11:36:44,02/04/2021 13:03:31,02/04/2021 13:35:29,240753,244826,4073,118
6101,02/04/2021 08:52:28,02/04/2021 08:52:35,02/04/2021 13:57:52,02/04/2021 14:59:41,302358,319051,16693,367
6101,02/04/2021 08:52:28,02/04/2021 08:52:35,02/04/2021 13:57:52,02/04/2021 14:59:41,302358,319051,16693,367
6101,02/04/2021 08:52:28,02/04/2021 08:52:35,02/04/2021 13:57:52,02/04/2021 14:59:41,302358,319051,16693,367
6101,02/04/2021 08:52:28,02/04/2021 08:52:35,02/04/2021 13:57:52,02/04/2021 14:59:41,302358,319051,16693,367
6155,02/04/2021 13:08:02,02/04/2021 13:08:06,02/04/2021 15:10:35,02/04/2021 15:10:55,67357,74327,6970,122
6168,02/04/2021 08:23:51,02/04/2021 08:23:52,02/04/2021 11:57:23,02/04/2021 18:13:14,273749415,273759585,10170,589
6127,02/04/2021 19:00:26,02/04/2021 19:00:27,02/04/2021 21:29:29,02/04/2021 21:29:45,219684,228081,8397,149
6118,02/04/2021 21:34:34,02/04/2021 21:34:42,03/04/2021 06:06:43,03/04/2021 06:06:52,2672627,2702472,29845,512
6189,02/04/2021 14:05:32,02/04/2021 14:05:34,02/04/2021 19:58:20,03/04/2021 08:37:13,276211353,276228423,17070,1111
6136,03/04/2021 09:23:11,03/04/2021 09:23:12,03/04/2021 10:48:42,03/04/2021 10:48:49,1535394,1540740,5346,85
6136,03/04/2021 11:58:22,03/04/2021 11:58:27,03/04/2021 17:24:20,03/04/2021 17:36:28,1540743,1559955,19212,338
6187,03/04/2021 14:36:31,03/04/2021 14:36:33,03/04/2021 17:12:46,03/04/2021 18:24:36,51165,59677,8512,228
6104,03/04/2021 14:23:32,03/04/2021 14:23:37,03/04/2021 18:40:24,03/04/2021 18:54:26,310955,323776,12821,270
6104,03/04/2021 14:23:32,03/04/2021 14:23:37,03/04/2021 18:40:24,03/04/2021 18:54:26,310955,323776,12821,270
6115,03/04/2021 16:12:16,03/04/2021 16:12:18,03/04/2021 19:12:29,03/04/2021 19:12:31,428424,439110,10686,180
6110,04/04/2021 09:27:21,04/04/2021 09:27:29,04/04/2021 11:06:40,04/04/2021 11:06:42,85285,91186,5901,99
6132,03/04/2021 10:44:57,03/04/2021 10:44:58,03/04/2021 16:38:42,04/04/2021 09:36:53,3266621,3286577,19956,1371
6136,04/04/2021 10:11:51,04/04/2021 10:11:56,04/04/2021 15:57:32,04/04/2021 15:58:23,1559996,1581343,21347,346
6123,04/04/2021 10:34:01,04/04/2021 10:34:02,04/04/2021 14:39:16,04/04/2021 15:42:18,152823,167693,14870,308
6116,04/04/2021 09:54:41,04/04/2021 09:54:43,04/04/2021 12:17:06,04/04/2021 12:50:24,468368,477281,8913,175
6184,03/04/2021 19:40:41,03/04/2021 19:40:42,04/04/2021 14:53:17,04/04/2021 15:35:10,757358,823909,66551,1194
6126,04/04/2021 16:28:53,04/04/2021 16:28:56,04/04/2021 20:08:50,04/04/2021 20:39:05,110557,119487,8930,250
6126,04/04/2021 16:28:53,04/04/2021 16:28:56,04/04/2021 20:08:50,04/04/2021 20:39:05,110557,119487,8930,250
6126,04/04/2021 16:28:53,04/04/2021 16:28:56,04/04/2021 20:08:50,04/04/2021 20:39:05,110557,119487,8930,250
6126,04/04/2021 16:28:53,04/04/2021 16:28:56,04/04/2021 20:08:50,04/04/2021 20:39:05,110557,119487,8930,250
6189,04/04/2021 17:28:33,04/04/2021 17:28:35,05/04/2021 08:16:45,05/04/2021 08:16:46,276228488,276246416,17928,888
6132,05/04/2021 08:10:15,05/04/2021 08:10:18,05/04/2021 10:30:19,05/04/2021 10:30:35,3286622,3294810,8188,140
6175,05/04/2021 12:40:34,05/04/2021 12:40:36,05/04/2021 15:44:20,05/04/2021 15:44:26,275167595,275178871,11276,183
6118,05/04/2021 14:06:52,05/04/2021 14:06:55,05/04/2021 17:37:29,05/04/2021 22:08:17,2702590,2711084,8494,481
6109,05/04/2021 12:09:42,05/04/2021 12:09:43,05/04/2021 15:11:54,05/04/2021 15:46:44,245020,252553,7533,217
6106,05/04/2021 15:01:14,05/04/2021 15:01:16,05/04/2021 16:46:28,05/04/2021 16:46:31,114602,120923,6321,105
6101,04/04/2021 17:32:59,04/04/2021 17:33:06,04/04/2021 19:34:54,05/04/2021 18:18:27,325825,332391,6566,1485
6189,05/04/2021 18:35:24,05/04/2021 18:35:26,06/04/2021 05:59:06,06/04/2021 05:59:08,276246436,276260511,14075,683
6139,05/04/2021 14:19:29,05/04/2021 14:19:32,06/04/2021 05:30:29,06/04/2021 07:27:25,409497,462902,53405,1027
6183,06/04/2021 16:18:01,06/04/2021 16:18:05,06/04/2021 21:26:34,06/04/2021 21:26:57,304643121,304661719,18598,308
6107,06/04/2021 17:06:02,06/04/2021 17:06:02,06/04/2021 17:06:02,06/04/2021 17:06:11,319940,319940,0,0
6107,06/04/2021 17:06:49,06/04/2021 17:06:49,06/04/2021 17:06:49,06/04/2021 17:07:09,319940,319940,0,0
6189,06/04/2021 18:47:58,06/04/2021 18:48:01,07/04/2021 05:09:45,07/04/2021 05:09:47,276260537,276261090,553,621
6107,06/04/2021 17:08:08,06/04/2021 17:08:09,07/04/2021 06:37:28,07/04/2021 06:37:39,319940,368572,48632,809
6115,07/04/2021 10:23:53,07/04/2021 10:23:55,07/04/2021 17:10:53,07/04/2021 17:14:01,439294,459504,20210,410
6189,07/04/2021 12:55:42,07/04/2021 12:55:47,07/04/2021 13:12:51,07/04/2021 13:12:53,276261105,276262072,967,17
6189,07/04/2021 13:49:50,07/04/2021 13:49:52,07/04/2021 14:35:02,07/04/2021 14:35:04,276262073,276264598,2525,45
6183,07/04/2021 15:51:18,07/04/2021 15:51:46,07/04/2021 20:43:20,07/04/2021 20:43:26,304661757,304679333,17576,292
6189,07/04/2021 15:40:35,07/04/2021 15:40:38,07/04/2021 17:11:20,07/04/2021 17:11:22,276264600,276269637,5037,90
6115,07/04/2021 17:23:56,07/04/2021 17:23:59,07/04/2021 17:24:15,07/04/2021 17:24:15,459504,459504,0,0
6148,07/04/2021 17:41:50,07/04/2021 17:41:51,07/04/2021 21:44:54,07/04/2021 22:13:45,170448,184708,14260,271
6115,07/04/2021 18:00:28,07/04/2021 18:00:32,07/04/2021 19:17:42,07/04/2021 19:19:17,459505,464217,4712,78
6189,07/04/2021 17:16:46,07/04/2021 17:16:48,08/04/2021 05:07:22,08/04/2021 05:07:24,276269637,276293501,23864,710
6104,07/04/2021 17:59:01,07/04/2021 17:59:07,07/04/2021 22:37:35,08/04/2021 05:34:52,324062,337698,13636,695
6132,08/04/2021 08:21:18,08/04/2021 08:21:20,08/04/2021 09:25:24,08/04/2021 09:25:29,3294950,3298680,3730,64
6168,07/04/2021 18:29:07,07/04/2021 18:29:08,08/04/2021 08:24:10,08/04/2021 08:24:30,273759867,273770488,10621,835
6106,08/04/2021 06:11:06,08/04/2021 06:11:14,08/04/2021 09:54:34,08/04/2021 10:36:19,121092,133278,12186,265
6115,08/04/2021 16:18:10,08/04/2021 16:18:14,08/04/2021 19:21:23,08/04/2021 19:21:33,464263,474320,10057,183
6132,08/04/2021 17:20:17,08/04/2021 17:20:18,08/04/2021 23:33:39,09/04/2021 07:23:12,3298695,3317501,18806,842
6106,08/04/2021 15:36:36,08/04/2021 15:36:37,08/04/2021 18:05:18,08/04/2021 18:05:45,133292,140631,7339,149
6119,08/04/2021 14:09:27,08/04/2021 14:09:34,08/04/2021 19:17:58,08/04/2021 19:18:08,895866,914418,18552,308
6107,08/04/2021 16:30:11,08/04/2021 16:30:13,09/04/2021 04:59:51,09/04/2021 04:59:54,368658,414119,45461,749
6109,08/04/2021 19:45:18,08/04/2021 19:45:19,09/04/2021 00:41:47,09/04/2021 05:28:29,252746,260751,8005,583
6189,08/04/2021 15:53:23,08/04/2021 15:53:25,09/04/2021 05:32:38,09/04/2021 05:32:40,276293522,276319844,26322,819
6118,09/04/2021 08:07:00,09/04/2021 08:07:09,09/04/2021 12:51:04,09/04/2021 13:54:18,2711252,2727026,15774,347
6111,09/04/2021 09:01:11,09/04/2021 09:01:13,09/04/2021 11:53:54,09/04/2021 11:53:58,110709,120983,10274,172
6118,09/04/2021 08:07:00,09/04/2021 08:07:09,09/04/2021 12:51:04,09/04/2021 13:54:18,2711252,2727026,15774,347
6118,09/04/2021 08:07:00,09/04/2021 08:07:09,09/04/2021 12:51:04,09/04/2021 13:54:18,2711252,2727026,15774,347
6118,09/04/2021 08:07:00,09/04/2021 08:07:09,09/04/2021 12:51:04,09/04/2021 13:54:18,2711252,2727026,15774,347
6189,09/04/2021 16:22:56,09/04/2021 16:23:01,09/04/2021 19:12:44,09/04/2021 19:12:46,276319865,276329307,9442,169
6189,09/04/2021 19:22:34,09/04/2021 19:22:34,09/04/2021 19:22:34,09/04/2021 19:22:56,276329308,276329308,0,0
6189,09/04/2021 19:23:34,09/04/2021 19:23:34,09/04/2021 19:23:34,09/04/2021 19:23:48,276329308,276329308,0,0
6151,09/04/2021 09:46:08,09/04/2021 09:46:09,10/04/2021 07:41:54,10/04/2021 07:41:56,102386857,102456836,69979,1315
6144,10/04/2021 11:03:31,10/04/2021 11:03:32,11/04/2021 00:49:33,11/04/2021 07:27:11,209987,258268,48281,1223
6112,10/04/2021 09:23:47,10/04/2021 09:23:53,10/04/2021 12:56:29,10/04/2021 12:56:33,232767,244230,11463,212
6121,10/04/2021 18:07:59,10/04/2021 18:08:00,10/04/2021 20:59:42,10/04/2021 23:21:20,149493,155910,6417,313
6130,10/04/2021 14:05:53,10/04/2021 14:05:54,10/04/2021 19:04:26,10/04/2021 19:05:14,105173,123093,17920,299
6104,10/04/2021 16:47:20,10/04/2021 16:47:25,10/04/2021 22:11:49,11/04/2021 11:13:02,337876,354731,16855,1105
6109,11/04/2021 07:48:30,11/04/2021 07:48:31,11/04/2021 12:37:35,11/04/2021 12:37:47,260886,267772,6886,289
6184,11/04/2021 14:14:52,11/04/2021 14:14:56,12/04/2021 06:27:10,12/04/2021 06:27:38,824267,855141,30874,972
6148,11/04/2021 14:37:26,11/04/2021 14:37:27,11/04/2021 18:36:26,11/04/2021 18:43:15,184971,199053,14082,245
6109,11/04/2021 13:51:08,11/04/2021 13:51:09,11/04/2021 15:33:49,11/04/2021 15:37:29,267776,272532,4756,106
6136,11/04/2021 15:55:01,11/04/2021 15:55:07,11/04/2021 20:49:30,12/04/2021 07:18:07,1581757,1599080,17323,923
6189,11/04/2021 14:32:45,11/04/2021 14:32:48,11/04/2021 16:25:36,11/04/2021 16:25:38,276329394,276335648,6254,112
6189,11/04/2021 14:32:45,11/04/2021 14:32:48,11/04/2021 16:25:36,11/04/2021 16:25:38,276329394,276335648,6254,112
6189,11/04/2021 14:32:45,11/04/2021 14:32:48,11/04/2021 16:25:36,11/04/2021 16:25:38,276329394,276335648,6254,112
6189,11/04/2021 14:32:45,11/04/2021 14:32:48,11/04/2021 16:25:36,11/04/2021 16:25:38,276329394,276335648,6254,112
6142,11/04/2021 16:27:02,11/04/2021 16:27:03,11/04/2021 20:13:10,11/04/2021 20:13:12,559822,572802,12980,226
6142,11/04/2021 16:27:02,11/04/2021 16:27:03,11/04/2021 20:13:10,11/04/2021 20:13:12,559822,572802,12980,226
6142,11/04/2021 16:27:02,11/04/2021 16:27:03,11/04/2021 20:13:10,11/04/2021 20:13:12,559822,572802,12980,226
6189,11/04/2021 17:10:21,11/04/2021 17:10:23,12/04/2021 05:11:36,12/04/2021 05:11:38,276335650,276350877,15227,721
6101,11/04/2021 19:15:03,11/04/2021 19:15:05,12/04/2021 07:33:59,12/04/2021 07:34:10,332741,375260,42519,739
6115,12/04/2021 15:59:50,12/04/2021 15:59:50,12/04/2021 15:59:50,12/04/2021 16:00:23,474547,474547,0,0
6112,12/04/2021 16:12:12,12/04/2021 16:12:16,12/04/2021 20:09:12,12/04/2021 20:09:26,244367,257191,12824,237
6130,12/04/2021 11:13:03,12/04/2021 11:13:04,12/04/2021 20:14:27,12/04/2021 20:14:58,123206,146277,23071,541
6116,12/04/2021 20:49:58,12/04/2021 20:49:59,13/04/2021 00:10:55,13/04/2021 00:12:39,477689,489336,11647,202
6121,12/04/2021 17:04:12,12/04/2021 17:04:13,12/04/2021 19:31:01,12/04/2021 20:57:54,156035,161438,5403,233
6132,12/04/2021 21:31:39,12/04/2021 21:31:46,13/04/2021 06:41:22,13/04/2021 06:41:25,3317671,3348394,30723,549
6189,12/04/2021 16:36:46,12/04/2021 16:36:48,13/04/2021 05:03:06,13/04/2021 05:03:08,276350900,276376781,25881,746
6147,13/04/2021 07:25:59,13/04/2021 07:26:01,13/04/2021 10:56:45,13/04/2021 14:56:27,341942,350290,8348,450
6103,13/04/2021 09:00:51,13/04/2021 09:00:52,13/04/2021 11:38:59,13/04/2021 12:25:24,159337,167717,8380,204
6193,13/04/2021 09:27:07,13/04/2021 09:27:10,13/04/2021 11:19:10,13/04/2021 11:19:15,389300,395789,6489,112
6183,13/04/2021 12:33:06,13/04/2021 12:34:07,13/04/2021 18:25:42,13/04/2021 18:25:49,304679618,304700700,21082,352
6116,13/04/2021 16:30:04,13/04/2021 18:38:17,13/04/2021 19:48:21,13/04/2021 19:48:51,489369,493922,4553,198
6168,13/04/2021 13:22:46,13/04/2021 13:22:47,13/04/2021 18:44:21,13/04/2021 18:44:31,273770772,273780966,10194,321
6116,13/04/2021 21:02:34,13/04/2021 21:02:55,13/04/2021 23:18:39,13/04/2021 23:26:02,493925,501675,7750,143
6116,13/04/2021 21:02:34,13/04/2021 21:02:55,13/04/2021 23:18:39,13/04/2021 23:26:02,493925,501675,7750,143
6116,13/04/2021 21:02:34,13/04/2021 21:02:55,13/04/2021 23:18:39,13/04/2021 23:26:02,493925,501675,7750,143
6116,13/04/2021 21:02:34,13/04/2021 21:02:55,13/04/2021 23:18:39,13/04/2021 23:26:02,493925,501675,7750,143
6109,13/04/2021 17:22:49,13/04/2021 17:22:50,14/04/2021 00:41:49,14/04/2021 05:22:54,272662,278170,5508,720
6182,13/04/2021 19:41:33,13/04/2021 19:41:37,14/04/2021 00:47:15,14/04/2021 05:34:59,273277380,273291862,14482,593
6189,13/04/2021 15:30:34,13/04/2021 15:30:36,14/04/2021 05:42:14,14/04/2021 05:42:16,276376802,276408064,31262,851
6116,14/04/2021 06:53:28,14/04/2021 06:53:34,14/04/2021 06:55:51,14/04/2021 06:56:13,501690,501830,140,2
6183,14/04/2021 09:45:51,14/04/2021 09:45:54,14/04/2021 15:07:16,14/04/2021 15:31:22,304700733,304719395,18662,345
6101,14/04/2021 06:32:44,14/04/2021 06:32:51,14/04/2021 11:04:14,14/04/2021 11:22:27,375382,389877,14495,289
6138,13/04/2021 14:31:27,13/04/2021 14:31:35,13/04/2021 16:37:11,14/04/2021 12:06:39,96156,102731,6575,1295
6136,14/04/2021 07:20:38,14/04/2021 07:20:39,14/04/2021 18:27:19,14/04/2021 18:27:21,1599201,1632806,33605,666
6119,14/04/2021 16:37:20,14/04/2021 16:37:26,14/04/2021 19:09:41,14/04/2021 19:09:53,914799,923975,9176,152
6189,14/04/2021 16:41:52,14/04/2021 16:41:54,15/04/2021 05:06:04,15/04/2021 05:06:06,276408086,276436111,28025,744
6142,14/04/2021 17:30:18,14/04/2021 17:30:20,14/04/2021 22:41:47,15/04/2021 08:29:05,572985,589190,16205,898
6161,15/04/2021 08:30:05,15/04/2021 08:30:09,15/04/2021 08:52:09,15/04/2021 08:52:24,305334377,305335016,639,22
6148,15/04/2021 18:35:33,15/04/2021 18:35:35,15/04/2021 21:00:11,15/04/2021 21:17:29,199339,206121,6782,161
6189,15/04/2021 15:33:02,15/04/2021 15:33:04,16/04/2021 06:49:36,16/04/2021 06:49:38,276436131,276467618,31487,916
6168,15/04/2021 19:05:29,15/04/2021 19:05:30,16/04/2021 07:33:16,16/04/2021 07:33:54,273781076,273791399,10323,748
6175,16/04/2021 11:31:20,16/04/2021 11:31:24,16/04/2021 13:59:04,16/04/2021 13:59:43,275179392,275186880,7488,148
6101,16/04/2021 09:25:13,16/04/2021 09:25:19,16/04/2021 12:12:56,16/04/2021 12:13:08,389995,399113,9118,167
6108,16/04/2021 14:52:36,16/04/2021 14:52:39,16/04/2021 14:58:41,16/04/2021 14:58:43,114710,115069,359,6
6116,16/04/2021 12:47:18,16/04/2021 12:47:26,16/04/2021 16:00:04,16/04/2021 16:23:05,501940,513531,11591,215
6101,16/04/2021 14:37:25,16/04/2021 14:37:31,16/04/2021 16:42:34,16/04/2021 18:37:17,399119,405647,6528,239
6182,16/04/2021 21:57:23,16/04/2021 21:57:27,17/04/2021 03:50:33,17/04/2021 05:47:37,273292012,273309467,17455,470
6143,17/04/2021 11:06:36,17/04/2021 11:06:41,17/04/2021 15:16:40,17/04/2021 15:17:05,1448991,1464220,15229,250
6121,17/04/2021 11:47:54,17/04/2021 11:47:55,17/04/2021 13:55:32,17/04/2021 17:25:27,161769,166678,4909,337
6136,17/04/2021 09:37:49,17/04/2021 09:37:51,17/04/2021 12:43:35,17/04/2021 12:59:34,1632962,1642903,9941,201
6136,17/04/2021 09:37:49,17/04/2021 09:37:51,17/04/2021 12:43:35,17/04/2021 12:59:34,1632962,1642903,9941,201
6136,17/04/2021 09:37:49,17/04/2021 09:37:51,17/04/2021 12:43:35,17/04/2021 12:59:34,1632962,1642903,9941,201
6136,17/04/2021 09:37:49,17/04/2021 09:37:51,17/04/2021 12:43:35,17/04/2021 12:59:34,1632962,1642903,9941,201
6136,17/04/2021 14:39:55,17/04/2021 14:40:00,17/04/2021 20:33:10,18/04/2021 07:40:06,1642908,1663972,21064,1020
6172,17/04/2021 15:12:06,17/04/2021 15:12:07,17/04/2021 20:59:17,17/04/2021 20:59:30,304629943,304651196,21253,347
6153,17/04/2021 15:45:35,17/04/2021 15:45:38,17/04/2021 19:40:20,17/04/2021 20:02:14,282709707,282720245,10538,256
6193,17/04/2021 10:19:24,17/04/2021 10:19:29,17/04/2021 12:34:07,17/04/2021 16:45:38,395981,403213,7232,386
6116,17/04/2021 16:20:40,17/04/2021 16:20:42,17/04/2021 17:42:09,17/04/2021 17:42:35,513580,518690,5110,81
6132,17/04/2021 20:22:30,17/04/2021 20:22:31,17/04/2021 20:23:21,17/04/2021 20:26:01,3348611,3348651,40,3
6132,17/04/2021 20:27:34,17/04/2021 20:27:34,17/04/2021 20:27:34,18/04/2021 05:24:08,3348651,3348672,21,536
6138,17/04/2021 20:51:05,17/04/2021 20:51:07,18/04/2021 08:54:13,18/04/2021 08:54:16,102904,144928,42024,723
6182,18/04/2021 11:38:53,18/04/2021 11:38:58,18/04/2021 14:46:58,18/04/2021 15:42:48,273309537,273317674,8137,243
6132,18/04/2021 18:42:25,18/04/2021 18:42:31,19/04/2021 08:43:50,19/04/2021 08:43:59,3348698,3392367,43669,841
6109,18/04/2021 17:15:40,18/04/2021 17:15:41,18/04/2021 20:11:08,18/04/2021 20:12:11,278454,286657,8203,176
6138,18/04/2021 15:42:00,18/04/2021 15:42:06,18/04/2021 17:43:27,18/04/2021 20:17:56,144944,151312,6368,275
6116,18/04/2021 14:00:47,18/04/2021 14:00:50,18/04/2021 17:21:17,18/04/2021 23:38:53,518731,531327,12596,578
6189,18/04/2021 16:07:48,18/04/2021 16:07:50,19/04/2021 04:59:25,19/04/2021 04:59:27,276467732,276494247,26515,771
6118,18/04/2021 18:56:04,18/04/2021 18:56:17,19/04/2021 00:06:02,19/04/2021 06:25:29,2727481,2745658,18177,689
6147,19/04/2021 07:37:39,19/04/2021 07:37:42,19/04/2021 11:15:04,19/04/2021 11:26:45,350670,359106,8436,229
6170,18/04/2021 22:42:52,18/04/2021 22:42:55,19/04/2021 07:39:35,19/04/2021 08:24:24,75315,107073,31758,581
6122,17/04/2021 18:04:00,17/04/2021 18:04:04,17/04/2021 18:04:04,17/04/2021 18:04:04,67423,67423,0,0
6146,19/04/2021 10:13:01,19/04/2021 10:13:02,19/04/2021 16:01:38,19/04/2021 16:01:40,159888,180239,20351,348
6151,19/04/2021 16:08:41,19/04/2021 16:08:48,19/04/2021 20:23:02,19/04/2021 20:23:14,102457465,102472048,14583,254
6175,19/04/2021 16:32:47,19/04/2021 16:32:52,19/04/2021 18:44:47,19/04/2021 18:44:57,275187029,275194440,7411,132
6189,19/04/2021 16:15:12,19/04/2021 16:15:14,20/04/2021 04:59:31,20/04/2021 04:59:33,276494269,276519510,25241,764
6147,20/04/2021 07:38:46,20/04/2021 07:38:50,20/04/2021 10:42:18,20/04/2021 12:04:30,359162,366708,7546,265
6121,20/04/2021 11:03:35,20/04/2021 11:03:36,20/04/2021 13:28:16,20/04/2021 13:32:56,166874,173926,7052,149
6175,20/04/2021 16:23:00,20/04/2021 16:23:04,20/04/2021 16:23:53,20/04/2021 16:24:02,275194485,275194528,43,1
6175,20/04/2021 16:24:23,20/04/2021 16:24:27,20/04/2021 22:47:58,21/04/2021 08:28:58,275194528,275213522,18994,964
6168,20/04/2021 17:13:14,20/04/2021 17:13:20,20/04/2021 20:04:12,20/04/2021 20:04:22,273791639,273801522,9883,171
6189,20/04/2021 16:58:36,20/04/2021 16:58:38,21/04/2021 04:46:01,21/04/2021 04:46:03,276519533,276541870,22337,707
6107,20/04/2021 17:11:17,20/04/2021 17:11:18,21/04/2021 06:51:52,21/04/2021 06:51:56,414820,464690,49870,820
6155,21/04/2021 10:22:32,21/04/2021 10:22:36,21/04/2021 10:23:01,21/04/2021 10:23:16,75270,75283,13,0
6155,21/04/2021 10:23:34,21/04/2021 10:23:38,21/04/2021 12:27:36,21/04/2021 12:27:55,75283,82354,7071,124
6123,21/04/2021 13:28:22,21/04/2021 13:28:23,21/04/2021 17:36:18,21/04/2021 19:23:39,168685,183789,15104,355
6193,21/04/2021 08:13:44,21/04/2021 08:13:49,21/04/2021 10:25:29,21/04/2021 14:02:39,403391,410488,7097,348
6168,21/04/2021 15:16:45,21/04/2021 15:16:46,21/04/2021 17:48:08,21/04/2021 17:48:21,273801565,273810387,8822,151
6189,21/04/2021 16:08:43,21/04/2021 16:08:45,22/04/2021 04:53:13,22/04/2021 04:53:15,276541893,276570895,29002,764
6104,21/04/2021 18:19:49,21/04/2021 18:19:52,21/04/2021 23:27:47,22/04/2021 05:31:38,355473,371703,16230,671
6118,22/04/2021 07:41:31,22/04/2021 07:41:34,22/04/2021 11:05:43,22/04/2021 13:10:41,2745816,2754115,8299,329
6112,22/04/2021 13:09:08,22/04/2021 13:09:15,22/04/2021 14:10:14,22/04/2021 14:10:23,257796,261711,3915,61
6151,22/04/2021 15:55:47,22/04/2021 15:55:50,22/04/2021 17:19:53,22/04/2021 17:19:55,102472236,102477025,4789,84
6118,22/04/2021 21:42:50,22/04/2021 21:42:59,23/04/2021 00:06:06,23/04/2021 06:21:48,2754133,2762494,8361,518
6189,22/04/2021 16:04:31,22/04/2021 16:04:33,23/04/2021 00:28:30,23/04/2021 06:47:23,276570917,276596707,25790,882
6118,23/04/2021 06:22:35,23/04/2021 06:22:47,23/04/2021 10:10:17,23/04/2021 10:10:35,2762494,2775734,13240,228
6118,23/04/2021 06:22:35,23/04/2021 06:22:47,23/04/2021 10:10:17,23/04/2021 10:10:35,2762494,2775734,13240,228
6118,23/04/2021 06:22:35,23/04/2021 06:22:47,23/04/2021 10:10:17,23/04/2021 10:10:35,2762494,2775734,13240,228
6118,23/04/2021 06:22:35,23/04/2021 06:22:47,23/04/2021 10:10:17,23/04/2021 10:10:35,2762494,2775734,13240,228
6143,23/04/2021 08:02:10,23/04/2021 08:02:12,23/04/2021 12:39:33,23/04/2021 12:39:35,1464537,1480195,15658,277
6151,23/04/2021 08:58:41,23/04/2021 08:58:42,23/04/2021 14:57:32,23/04/2021 14:57:36,102477072,102498280,21208,358
6118,23/04/2021 14:27:02,23/04/2021 14:27:10,23/04/2021 16:53:02,23/04/2021 17:02:28,2775740,2783687,7947,155
6151,23/04/2021 17:42:25,23/04/2021 17:42:30,23/04/2021 21:11:22,23/04/2021 21:11:35,102498288,102510259,11971,209
6168,23/04/2021 15:54:53,23/04/2021 15:55:00,23/04/2021 19:34:20,23/04/2021 19:34:30,273810493,273823329,12836,219
6168,23/04/2021 15:54:53,23/04/2021 15:55:00,23/04/2021 19:34:20,23/04/2021 19:34:30,273810493,273823329,12836,219
6168,23/04/2021 15:54:53,23/04/2021 15:55:00,23/04/2021 19:34:20,23/04/2021 19:34:30,273810493,273823329,12836,219
6168,23/04/2021 15:54:53,23/04/2021 15:55:00,23/04/2021 19:34:20,23/04/2021 19:34:30,273810493,273823329,12836,219
6151,23/04/2021 21:52:14,23/04/2021 21:52:16,23/04/2021 21:59:13,23/04/2021 21:59:13,102510260,102510671,411,6
6132,23/04/2021 17:41:58,23/04/2021 17:41:59,23/04/2021 22:01:49,24/04/2021 07:58:48,3392551,3407060,14509,856
6132,24/04/2021 13:00:12,24/04/2021 13:00:19,24/04/2021 18:59:36,25/04/2021 05:11:48,3407070,3426251,19181,971
6187,24/04/2021 11:17:47,24/04/2021 11:17:55,24/04/2021 13:44:33,24/04/2021 13:44:36,60749,69031,8282,146
6139,24/04/2021 10:31:11,24/04/2021 10:31:12,24/04/2021 14:30:35,24/04/2021 14:30:37,464132,478551,14419,239
6127,24/04/2021 14:42:57,24/04/2021 14:43:01,24/04/2021 14:46:04,24/04/2021 14:47:18,234599,234781,182,4
6136,24/04/2021 14:48:46,24/04/2021 14:48:51,24/04/2021 22:05:52,24/04/2021 22:32:53,1664343,1690860,26517,464
6116,24/04/2021 09:11:01,24/04/2021 09:11:03,25/04/2021 03:07:21,25/04/2021 07:21:51,531587,596241,64654,1330
6139,24/04/2021 15:55:23,24/04/2021 15:55:24,25/04/2021 06:00:03,25/04/2021 08:49:12,478555,527621,49066,1013
6184,24/04/2021 11:57:39,24/04/2021 11:57:41,25/04/2021 06:53:19,25/04/2021 09:56:41,855770,920579,64809,1319
6184,24/04/2021 11:57:39,24/04/2021 11:57:41,25/04/2021 06:53:19,25/04/2021 09:56:41,855770,920579,64809,1319
6184,24/04/2021 11:57:39,24/04/2021 11:57:41,25/04/2021 06:53:19,25/04/2021 09:56:41,855770,920579,64809,1319
6184,24/04/2021 11:57:39,24/04/2021 11:57:41,25/04/2021 06:53:19,25/04/2021 09:56:41,855770,920579,64809,1319
6133,24/04/2021 11:29:57,24/04/2021 11:30:00,24/04/2021 22:31:34,25/04/2021 10:14:02,493941,531974,38033,1364
6101,25/04/2021 07:05:45,25/04/2021 07:05:51,25/04/2021 09:05:25,25/04/2021 10:38:49,406134,412702,6568,213
6123,25/04/2021 16:10:03,25/04/2021 16:10:04,25/04/2021 19:03:17,25/04/2021 19:23:36,184018,194450,10432,193
6148,25/04/2021 17:25:49,25/04/2021 17:25:50,25/04/2021 19:46:12,25/04/2021 20:27:10,206809,213740,6931,181
6187,25/04/2021 15:56:05,25/04/2021 15:56:06,25/04/2021 17:55:56,25/04/2021 17:56:00,69091,75892,6801,119
6139,25/04/2021 22:54:20,25/04/2021 22:54:21,26/04/2021 02:17:24,26/04/2021 02:25:48,527661,540217,12556,211
6189,25/04/2021 14:20:39,25/04/2021 14:20:41,26/04/2021 04:59:53,26/04/2021 04:59:55,276596817,276626961,30144,879
6118,26/04/2021 07:37:21,26/04/2021 07:37:25,26/04/2021 10:57:53,26/04/2021 11:11:27,2783822,2791933,8111,214
6123,26/04/2021 08:54:10,26/04/2021 08:54:14,26/04/2021 08:56:09,26/04/2021 08:56:14,194481,194592,111,2
6123,26/04/2021 08:57:27,26/04/2021 08:57:30,26/04/2021 10:02:00,26/04/2021 10:02:08,194592,198504,3912,64
6116,26/04/2021 08:00:45,26/04/2021 08:00:52,26/04/2021 10:23:08,26/04/2021 10:23:15,596291,605458,9167,142
6138,25/04/2021 23:04:18,25/04/2021 23:04:20,26/04/2021 11:07:41,26/04/2021 11:07:45,151671,193606,41935,723
6107,26/04/2021 09:22:26,26/04/2021 09:22:33,26/04/2021 21:09:33,26/04/2021 21:09:48,464991,499760,34769,707
6155,26/04/2021 16:09:43,26/04/2021 16:09:45,26/04/2021 21:41:48,26/04/2021 21:41:50,82619,87999,5380,332
6155,26/04/2021 16:09:43,26/04/2021 16:09:45,26/04/2021 21:41:48,26/04/2021 21:41:50,82619,87999,5380,332
6116,26/04/2021 17:42:11,26/04/2021 17:42:13,26/04/2021 20:51:04,26/04/2021 22:43:02,605473,617338,11865,300
6189,26/04/2021 15:38:26,26/04/2021 15:38:28,27/04/2021 04:48:56,27/04/2021 04:48:58,276626982,276655882,28900,790
6151,26/04/2021 15:59:17,26/04/2021 15:59:18,27/04/2021 06:40:32,27/04/2021 06:40:42,102510912,102562814,51902,881
6118,26/04/2021 20:09:02,26/04/2021 20:09:28,27/04/2021 00:06:01,27/04/2021 07:10:06,2791951,2805772,13821,661
6118,27/04/2021 07:38:05,27/04/2021 07:38:08,27/04/2021 10:45:17,27/04/2021 12:18:07,2805774,2813223,7449,280
6101,27/04/2021 14:08:26,27/04/2021 14:08:32,27/04/2021 15:53:45,27/04/2021 15:53:48,412836,418850,6014,105
6116,27/04/2021 17:44:37,27/04/2021 17:44:48,27/04/2021 17:44:54,27/04/2021 17:44:55,617376,617376,0,0
6155,27/04/2021 18:01:09,27/04/2021 18:01:14,27/04/2021 21:44:39,27/04/2021 21:45:00,88044,99597,11553,223
6148,27/04/2021 18:38:04,27/04/2021 18:38:05,27/04/2021 20:44:39,27/04/2021 21:22:38,213873,219928,6055,164
6109,27/04/2021 18:35:05,27/04/2021 18:35:06,27/04/2021 21:01:02,27/04/2021 21:01:08,287212,295100,7888,146
6189,27/04/2021 15:41:19,27/04/2021 15:41:21,28/04/2021 04:55:03,28/04/2021 04:55:05,276655904,276682937,27033,793
6101,27/04/2021 18:21:27,27/04/2021 18:21:29,28/04/2021 04:10:13,28/04/2021 04:55:28,418856,452831,33975,634
6132,27/04/2021 16:58:47,27/04/2021 16:58:49,27/04/2021 22:42:10,28/04/2021 06:57:37,3426370,3445606,19236,838
6132,27/04/2021 16:58:47,27/04/2021 16:58:49,27/04/2021 22:42:10,28/04/2021 06:57:37,3426370,3445606,19236,838
6132,27/04/2021 16:58:47,27/04/2021 16:58:49,27/04/2021 22:42:10,28/04/2021 06:57:37,3426370,3445606,19236,838
6132,27/04/2021 16:58:47,27/04/2021 16:58:49,27/04/2021 22:42:10,28/04/2021 06:57:37,3426370,3445606,19236,838
6142,27/04/2021 20:03:24,27/04/2021 20:03:24,27/04/2021 20:03:24,28/04/2021 07:12:12,589903,589936,33,668
6106,28/04/2021 08:01:00,28/04/2021 08:01:08,28/04/2021 10:42:34,28/04/2021 11:14:23,141870,150724,8854,193
6151,28/04/2021 14:07:13,28/04/2021 14:07:19,28/04/2021 20:24:49,28/04/2021 20:27:31,102562919,102584001,21082,380
6142,28/04/2021 07:12:40,28/04/2021 07:12:41,28/04/2021 18:14:50,28/04/2021 18:14:55,589936,626413,36477,662
6118,28/04/2021 14:48:38,28/04/2021 14:48:39,28/04/2021 18:18:45,28/04/2021 18:45:58,2813277,2825404,12127,237
6118,28/04/2021 14:48:38,28/04/2021 14:48:39,28/04/2021 18:18:45,28/04/2021 18:45:58,2813277,2825404,12127,237
6118,28/04/2021 14:48:38,28/04/2021 14:48:39,28/04/2021 18:18:45,28/04/2021 18:45:58,2813277,2825404,12127,237
6118,28/04/2021 14:48:38,28/04/2021 14:48:39,28/04/2021 18:18:45,28/04/2021 18:45:58,2813277,2825404,12127,237
6189,28/04/2021 14:15:31,28/04/2021 14:15:33,29/04/2021 04:43:22,29/04/2021 04:43:24,276682956,276701493,18537,867
6109,28/04/2021 21:06:57,28/04/2021 21:06:58,28/04/2021 23:59:17,29/04/2021 05:23:11,295164,303060,7896,496
6147,29/04/2021 07:45:35,29/04/2021 07:45:38,29/04/2021 10:53:53,29/04/2021 12:14:13,367251,374430,7179,268
6148,29/04/2021 09:43:08,29/04/2021 09:43:15,29/04/2021 11:05:11,29/04/2021 11:05:15,220034,224990,4956,82
6132,29/04/2021 12:29:55,29/04/2021 12:29:59,29/04/2021 14:53:14,29/04/2021 14:53:16,3445665,3453271,7606,143
6189,29/04/2021 14:45:44,29/04/2021 14:45:47,29/04/2021 16:36:13,29/04/2021 16:36:15,276701513,276707623,6110,110
6168,29/04/2021 10:47:36,29/04/2021 10:47:43,29/04/2021 13:35:08,29/04/2021 13:35:16,273823632,273833469,9837,167
6148,29/04/2021 18:43:51,29/04/2021 18:43:52,29/04/2021 21:08:25,29/04/2021 21:35:59,225012,231990,6978,172
6116,29/04/2021 20:03:45,29/04/2021 20:04:11,29/04/2021 23:29:12,29/04/2021 23:44:36,617478,629369,11891,220
6116,29/04/2021 20:03:45,29/04/2021 20:04:11,29/04/2021 23:29:12,29/04/2021 23:44:36,617478,629369,11891,220
6116,29/04/2021 20:03:45,29/04/2021 20:04:11,29/04/2021 23:29:12,29/04/2021 23:44:36,617478,629369,11891,220
6116,29/04/2021 20:03:45,29/04/2021 20:04:11,29/04/2021 23:29:12,29/04/2021 23:44:36,617478,629369,11891,220
6116,29/04/2021 23:48:22,29/04/2021 23:48:22,29/04/2021 23:48:22,29/04/2021 23:49:05,629369,629369,0,0
6189,29/04/2021 16:45:32,29/04/2021 16:45:33,30/04/2021 04:54:10,30/04/2021 04:54:12,276707624,276727425,19801,728
6101,29/04/2021 14:09:26,29/04/2021 14:09:32,29/04/2021 16:13:54,30/04/2021 06:57:21,452917,459421,6504,1007
6138,29/04/2021 20:33:05,29/04/2021 20:33:07,30/04/2021 07:09:04,30/04/2021 07:09:24,193798,230713,36915,636
6121,30/04/2021 09:01:57,30/04/2021 09:02:03,30/04/2021 11:09:25,30/04/2021 11:09:28,174626,182482,7856,127
6121,30/04/2021 09:01:57,30/04/2021 09:02:03,30/04/2021 11:09:25,30/04/2021 11:09:28,174626,182482,7856,127
6121,30/04/2021 09:01:57,30/04/2021 09:02:03,30/04/2021 11:09:25,30/04/2021 11:09:28,174626,182482,7856,127
6121,30/04/2021 09:01:57,30/04/2021 09:02:03,30/04/2021 11:09:25,30/04/2021 11:09:28,174626,182482,7856,127
6116,30/04/2021 14:07:41,30/04/2021 14:07:42,30/04/2021 15:54:03,30/04/2021 16:12:27,629398,635236,5838,124
6118,30/04/2021 14:15:16,30/04/2021 14:15:19,30/04/2021 17:02:48,30/04/2021 17:30:51,2825481,2832116,6635,195
6136,30/04/2021 16:29:16,30/04/2021 16:29:17,30/04/2021 19:12:55,30/04/2021 19:12:57,1691196,1699944,8748,163
6132,30/04/2021 20:05:43,30/04/2021 20:05:49,30/04/2021 20:19:12,30/04/2021 20:19:19,3453330,3454077,747,13
6132,30/04/2021 20:21:38,30/04/2021 20:21:45,30/04/2021 20:36:46,30/04/2021 20:36:55,3454078,3454919,841,15
6155,30/04/2021 15:25:26,30/04/2021 15:25:27,30/04/2021 20:46:20,30/04/2021 20:46:22,99731,105396,5665,320
6138,30/04/2021 20:02:29,30/04/2021 20:02:31,01/05/2021 05:33:25,01/05/2021 05:48:55,230745,263980,33235,586
6136,30/04/2021 22:34:57,30/04/2021 22:34:59,01/05/2021 07:28:19,01/05/2021 07:28:21,1699953,1730086,30133,533
6147,01/05/2021 07:42:06,01/05/2021 07:42:09,01/05/2021 10:49:10,01/05/2021 10:52:01,374551,381916,7365,189
6189,30/04/2021 16:21:26,30/04/2021 16:21:28,30/04/2021 23:36:24,01/05/2021 08:17:15,276727448,276749186,21738,955
6193,30/04/2021 17:16:18,30/04/2021 17:16:23,30/04/2021 19:29:02,01/05/2021 08:28:57,418192,425378,7186,912
6151,30/04/2021 19:24:37,30/04/2021 19:24:38,01/05/2021 08:35:49,01/05/2021 08:35:52,102584166,102630901,46735,791
6132,01/05/2021 10:21:06,01/05/2021 10:21:12,02/05/2021 00:09:24,02/05/2021 11:31:15,3454946,3500825,45879,1510
6143,01/05/2021 13:25:25,01/05/2021 13:25:30,01/05/2021 16:29:46,01/05/2021 16:30:15,1480630,1491813,11183,184
6139,01/05/2021 18:57:07,01/05/2021 18:57:08,01/05/2021 22:20:06,01/05/2021 22:21:04,540601,553187,12586,203
6115,01/05/2021 15:15:41,01/05/2021 15:15:45,01/05/2021 19:18:56,01/05/2021 19:19:14,475676,489601,13925,243
6119,02/05/2021 11:51:05,02/05/2021 11:51:06,02/05/2021 16:08:03,02/05/2021 16:08:07,925116,935493,10377,257
6189,02/05/2021 18:09:44,02/05/2021 18:09:45,02/05/2021 22:38:24,02/05/2021 22:38:34,276749253,276765183,15930,268
6116,02/05/2021 13:17:37,02/05/2021 13:17:39,02/05/2021 16:40:43,02/05/2021 19:31:42,635327,648151,12824,374
6118,02/05/2021 12:39:51,02/05/2021 12:39:54,02/05/2021 19:33:47,02/05/2021 19:39:28,2832202,2856440,24238,419
6136,03/05/2021 12:00:02,03/05/2021 12:00:08,03/05/2021 19:23:20,04/05/2021 06:34:02,1730214,1756342,26128,1114
6121,03/05/2021 16:02:10,03/05/2021 16:02:11,03/05/2021 18:31:15,03/05/2021 20:33:40,182711,189649,6938,271
6101,03/05/2021 15:26:06,03/05/2021 15:26:13,03/05/2021 17:03:24,03/05/2021 17:03:36,459602,464813,5211,97
6189,03/05/2021 13:10:19,03/05/2021 13:10:21,03/05/2021 16:59:24,03/05/2021 18:41:59,276765212,276775422,10210,331
6132,03/05/2021 16:13:51,03/05/2021 16:13:55,03/05/2021 19:40:26,03/05/2021 19:40:39,3500882,3512952,12070,206
6189,03/05/2021 19:22:14,03/05/2021 19:22:18,03/05/2021 20:12:08,03/05/2021 20:12:36,276775423,276778186,2763,50
6147,04/05/2021 07:40:28,04/05/2021 07:40:32,04/05/2021 10:06:45,04/05/2021 10:06:48,382104,389246,7142,146
6147,04/05/2021 07:40:28,04/05/2021 07:40:32,04/05/2021 10:06:45,04/05/2021 10:06:48,382104,389246,7142,146
6115,04/05/2021 17:36:17,04/05/2021 17:36:21,04/05/2021 20:56:04,04/05/2021 20:56:13,489788,501978,12190,199
6177,04/05/2021 18:48:16,04/05/2021 18:48:23,04/05/2021 21:30:40,04/05/2021 21:30:43,77214,87011,9797,162
6170,04/05/2021 19:48:30,04/05/2021 19:48:32,04/05/2021 23:05:50,04/05/2021 23:05:53,107822,119661,11839,197
6189,04/05/2021 15:33:05,04/05/2021 15:33:06,05/05/2021 04:52:36,05/05/2021 04:52:38,276778223,276805641,27418,799
6137,05/05/2021 10:11:22,05/05/2021 10:11:24,05/05/2021 12:23:32,05/05/2021 12:23:34,100948,108923,7975,132
6151,05/05/2021 13:34:28,05/05/2021 13:34:34,05/05/2021 19:17:59,05/05/2021 20:12:08,102631168,102650287,19119,397
6144,05/05/2021 14:12:24,05/05/2021 14:12:28,05/05/2021 14:40:35,05/05/2021 14:40:40,259824,261504,1680,28
6106,05/05/2021 16:01:25,05/05/2021 16:01:31,05/05/2021 17:31:08,05/05/2021 17:31:17,151187,156046,4859,89
6151,05/05/2021 13:34:28,05/05/2021 13:34:34,05/05/2021 19:17:59,05/05/2021 20:12:08,102631168,102650287,19119,397
6189,05/05/2021 15:38:27,05/05/2021 15:38:29,06/05/2021 05:04:22,06/05/2021 05:04:24,276805662,276834778,29116,805
6118,05/05/2021 21:16:47,05/05/2021 21:16:57,06/05/2021 06:54:54,06/05/2021 06:54:59,2856580,2866475,9895,578
6147,05/05/2021 20:23:27,05/05/2021 20:23:30,06/05/2021 00:03:29,06/05/2021 07:14:03,389342,397509,8167,650
6193,06/05/2021 08:26:06,06/05/2021 08:26:10,06/05/2021 10:16:50,06/05/2021 10:17:10,425618,432065,6447,111
6148,06/05/2021 09:40:17,06/05/2021 09:40:23,06/05/2021 10:52:00,06/05/2021 10:52:11,232434,236737,4303,71
6115,06/05/2021 09:15:55,06/05/2021 09:16:00,06/05/2021 12:56:57,06/05/2021 12:57:09,502079,515506,13427,221
6123,06/05/2021 11:13:17,06/05/2021 11:13:19,06/05/2021 14:12:56,06/05/2021 15:03:31,199110,210097,10987,230
6136,06/05/2021 06:56:18,06/05/2021 06:56:19,06/05/2021 13:07:32,06/05/2021 17:13:24,1756459,1780085,23626,617
6175,06/05/2021 17:09:51,06/05/2021 17:09:53,06/05/2021 17:49:01,06/05/2021 17:49:03,275214258,275216468,2210,39
6109,06/05/2021 15:58:06,06/05/2021 15:58:07,06/05/2021 19:03:57,06/05/2021 20:35:41,303523,310989,7466,277
6189,06/05/2021 16:20:17,06/05/2021 16:20:18,07/05/2021 05:06:33,07/05/2021 05:06:35,276834800,276861660,26860,766
6151,06/05/2021 18:28:42,06/05/2021 18:28:44,07/05/2021 06:42:32,07/05/2021 06:42:36,102650349,102693620,43271,733
6142,07/05/2021 17:37:50,07/05/2021 17:37:51,07/05/2021 18:37:06,07/05/2021 18:37:08,671152,674432,3280,59
6109,07/05/2021 16:42:38,07/05/2021 16:42:39,07/05/2021 19:11:48,07/05/2021 21:14:25,311042,317757,6715,271
6136,07/05/2021 11:38:05,07/05/2021 11:38:06,08/05/2021 07:02:40,08/05/2021 07:02:42,1780131,1814426,34295,1164
6188,08/05/2021 07:22:19,08/05/2021 07:22:20,08/05/2021 18:47:47,08/05/2021 18:47:49,274367672,274406470,38798,685
6189,07/05/2021 20:03:20,07/05/2021 20:03:21,08/05/2021 08:12:21,08/05/2021 08:12:23,276861690,276891279,29589,729
6136,08/05/2021 11:20:16,08/05/2021 11:20:21,08/05/2021 16:46:56,08/05/2021 16:47:35,1814437,1834831,20394,327
6123,08/05/2021 14:04:22,08/05/2021 14:04:23,08/05/2021 18:22:04,08/05/2021 18:31:55,210210,225876,15666,267
6101,08/05/2021 10:11:50,08/05/2021 10:11:53,08/05/2021 13:47:08,08/05/2021 15:52:07,465066,478189,13123,340
6138,08/05/2021 14:52:24,08/05/2021 14:52:31,08/05/2021 17:11:32,08/05/2021 17:11:40,321491,329012,7521,139
6136,08/05/2021 17:58:10,08/05/2021 17:58:15,08/05/2021 23:57:45,09/05/2021 09:45:35,1834834,1856549,21715,947
6189,08/05/2021 18:12:42,08/05/2021 18:12:43,08/05/2021 21:50:46,08/05/2021 21:50:54,276891299,276904222,12923,218
6101,08/05/2021 21:04:15,08/05/2021 21:04:18,09/05/2021 04:02:26,09/05/2021 04:02:30,478201,502490,24289,418
6138,09/05/2021 06:44:44,09/05/2021 06:44:52,09/05/2021 09:54:00,09/05/2021 09:55:44,329040,339290,10250,191
6138,09/05/2021 06:44:44,09/05/2021 06:44:52,09/05/2021 09:54:00,09/05/2021 09:55:44,329040,339290,10250,191
6161,09/05/2021 12:08:42,09/05/2021 12:08:47,09/05/2021 13:44:55,09/05/2021 13:45:04,305336183,305341808,5625,96
6138,09/05/2021 14:03:12,09/05/2021 14:03:14,09/05/2021 14:55:41,09/05/2021 15:10:17,339298,342526,3228,67
6121,09/05/2021 16:46:33,09/05/2021 16:46:34,09/05/2021 19:19:34,09/05/2021 20:14:20,190063,197117,7054,207
6192,09/05/2021 16:14:28,09/05/2021 16:14:29,09/05/2021 20:53:18,09/05/2021 20:53:20,27891,33199,5308,278
6189,09/05/2021 16:18:31,09/05/2021 16:18:33,10/05/2021 05:15:52,10/05/2021 05:15:54,276904257,276922457,18200,777
6132,10/05/2021 17:25:04,10/05/2021 17:25:05,10/05/2021 18:29:49,10/05/2021 18:29:59,3513282,3517036,3754,64
6130,10/05/2021 18:52:45,10/05/2021 18:52:50,10/05/2021 18:53:18,10/05/2021 18:54:25,148084,148101,17,1
6130,10/05/2021 18:54:51,10/05/2021 18:55:06,10/05/2021 19:45:16,10/05/2021 19:47:34,148101,151324,3223,52
6132,10/05/2021 18:31:13,10/05/2021 18:31:14,10/05/2021 19:24:35,10/05/2021 19:24:48,3517036,3520142,3106,53
6130,10/05/2021 19:48:02,10/05/2021 19:48:06,10/05/2021 20:15:33,10/05/2021 20:16:48,151324,152589,1265,28
6116,11/05/2021 09:22:23,11/05/2021 09:22:25,11/05/2021 12:46:13,11/05/2021 15:24:59,648566,661444,12878,362
6121,11/05/2021 18:22:02,11/05/2021 18:22:03,11/05/2021 21:10:15,11/05/2021 22:06:14,197251,204597,7346,224
6172,11/05/2021 16:49:48,11/05/2021 16:49:50,12/05/2021 03:03:43,12/05/2021 05:13:00,304652533,304685252,32719,743
6115,11/05/2021 17:29:39,11/05/2021 17:29:43,11/05/2021 22:55:08,12/05/2021 06:52:33,515834,533141,17307,802
6132,11/05/2021 17:03:31,11/05/2021 17:03:32,12/05/2021 01:51:44,12/05/2021 07:01:20,3520185,3550406,30221,837
6151,11/05/2021 19:33:43,11/05/2021 19:33:44,12/05/2021 07:42:37,12/05/2021 07:42:41,102693896,102736898,43002,728
6150,12/05/2021 09:48:17,12/05/2021 09:48:19,12/05/2021 10:57:48,12/05/2021 10:57:50,155691,159801,4110,69
6126,12/05/2021 17:07:48,12/05/2021 17:07:49,12/05/2021 18:02:32,12/05/2021 18:02:34,121259,124637,3378,54
6138,13/05/2021 00:28:02,13/05/2021 00:28:04,13/05/2021 08:05:30,13/05/2021 08:05:35,342718,369039,26321,457
6151,13/05/2021 16:23:34,13/05/2021 16:23:41,13/05/2021 20:06:47,13/05/2021 20:06:59,102736979,102749761,12782,223
6172,13/05/2021 14:10:02,13/05/2021 14:10:04,13/05/2021 20:25:13,13/05/2021 20:25:15,304685318,304706943,21625,375
6132,13/05/2021 22:26:14,13/05/2021 22:26:20,14/05/2021 06:53:15,14/05/2021 06:53:22,3550478,3579940,29462,507
6118,14/05/2021 06:36:26,14/05/2021 06:36:27,14/05/2021 10:40:38,14/05/2021 11:57:07,2866746,2880173,13427,320
6118,14/05/2021 06:36:26,14/05/2021 06:36:27,14/05/2021 10:40:38,14/05/2021 11:57:07,2866746,2880173,13427,320
6118,14/05/2021 06:36:26,14/05/2021 06:36:27,14/05/2021 10:40:38,14/05/2021 11:57:07,2866746,2880173,13427,320
6118,14/05/2021 06:36:26,14/05/2021 06:36:27,14/05/2021 10:40:38,14/05/2021 11:57:07,2866746,2880173,13427,320
6118,14/05/2021 12:26:47,14/05/2021 12:26:47,14/05/2021 12:26:47,14/05/2021 12:26:49,2880174,2880174,0,0
6112,14/05/2021 09:21:31,14/05/2021 09:21:36,14/05/2021 12:59:50,14/05/2021 13:00:07,263174,276612,13438,218
6123,14/05/2021 13:27:25,14/05/2021 13:27:27,14/05/2021 16:24:59,14/05/2021 16:25:03,226198,236978,10780,177
6123,14/05/2021 13:27:25,14/05/2021 13:27:27,14/05/2021 16:24:59,14/05/2021 16:25:03,226198,236978,10780,177
6123,14/05/2021 13:27:25,14/05/2021 13:27:27,14/05/2021 16:24:59,14/05/2021 16:25:03,226198,236978,10780,177
6123,14/05/2021 13:27:25,14/05/2021 13:27:27,14/05/2021 16:24:59,14/05/2021 16:25:03,226198,236978,10780,177
6155,14/05/2021 15:23:53,14/05/2021 15:23:54,14/05/2021 21:25:48,14/05/2021 21:25:50,106073,111761,5688,361
6184,14/05/2021 19:53:00,14/05/2021 19:53:01,15/05/2021 06:15:17,15/05/2021 06:15:19,921547,957523,35976,622
6101,14/05/2021 17:20:23,14/05/2021 17:20:26,15/05/2021 06:22:01,15/05/2021 06:22:05,502811,548037,45226,781
6112,14/05/2021 17:27:30,14/05/2021 17:27:34,14/05/2021 20:23:23,15/05/2021 08:13:15,276625,284815,8190,885
6151,14/05/2021 16:06:21,14/05/2021 16:06:22,15/05/2021 08:36:39,15/05/2021 08:36:44,102749832,102808083,58251,990
6132,14/05/2021 23:08:26,14/05/2021 23:08:27,15/05/2021 02:16:16,15/05/2021 09:33:25,3579973,3588211,8238,624
6168,15/05/2021 10:15:57,15/05/2021 10:16:00,15/05/2021 10:45:32,15/05/2021 10:45:35,273834258,273835965,1707,29
6136,15/05/2021 13:33:17,15/05/2021 13:33:21,15/05/2021 21:05:57,15/05/2021 21:45:24,1856889,1883942,27053,492
6189,10/05/2021 16:48:26,10/05/2021 16:48:28,10/05/2021 16:48:28,10/05/2021 16:48:28,276922480,276924611,2131,0
6186,15/05/2021 11:55:46,15/05/2021 11:55:47,15/05/2021 18:20:13,15/05/2021 18:20:32,273088516,273111864,23348,384
6172,15/05/2021 20:01:25,15/05/2021 20:01:26,15/05/2021 20:28:13,15/05/2021 20:28:33,304707064,304708714,1650,27
6132,15/05/2021 20:42:52,15/05/2021 20:42:53,16/05/2021 07:29:21,16/05/2021 12:28:34,3588234,3623806,35572,945
6119,15/05/2021 14:48:50,15/05/2021 14:48:52,16/05/2021 05:47:33,16/05/2021 07:42:52,936308,989356,53048,1014
6109,15/05/2021 17:39:06,15/05/2021 17:39:07,16/05/2021 00:41:49,16/05/2021 07:52:42,318255,326509,8254,853
6112,15/05/2021 17:52:04,15/05/2021 17:52:08,15/05/2021 23:21:30,16/05/2021 08:49:44,284842,302806,17964,897
6186,16/05/2021 13:23:18,16/05/2021 13:23:18,16/05/2021 13:23:18,16/05/2021 13:50:33,273111904,273111905,1,27
6186,16/05/2021 13:52:46,16/05/2021 13:52:47,16/05/2021 17:24:50,16/05/2021 17:25:09,273111905,273123909,12004,212
6116,16/05/2021 14:45:20,16/05/2021 14:45:22,16/05/2021 17:29:10,16/05/2021 19:23:44,661675,671965,10290,278
6189,16/05/2021 16:53:09,16/05/2021 16:53:11,17/05/2021 05:00:14,17/05/2021 05:00:16,276924661,276951867,27206,727
6130,17/05/2021 12:25:33,17/05/2021 12:25:37,17/05/2021 16:52:32,17/05/2021 16:52:32,153012,170075,17063,266
6116,17/05/2021 11:57:45,17/05/2021 11:57:48,17/05/2021 12:39:29,17/05/2021 12:39:35,671998,673593,1595,41
6121,17/05/2021 15:48:15,17/05/2021 15:48:16,17/05/2021 18:15:02,17/05/2021 19:50:33,204989,212174,7185,242
6138,17/05/2021 11:19:09,17/05/2021 11:19:15,17/05/2021 13:24:09,17/05/2021 16:17:03,369272,375785,6513,297
6106,17/05/2021 12:39:32,17/05/2021 12:39:40,17/05/2021 16:06:51,17/05/2021 17:06:20,156793,168157,11364,266
6109,17/05/2021 17:24:59,17/05/2021 17:25:00,17/05/2021 19:07:54,17/05/2021 19:08:01,326602,331307,4705,103
6189,17/05/2021 15:25:37,17/05/2021 15:25:39,18/05/2021 05:00:02,18/05/2021 05:00:04,276951888,276970401,18513,814
6138,17/05/2021 17:04:23,17/05/2021 17:04:25,18/05/2021 06:08:26,18/05/2021 06:08:35,375786,421255,45469,784
6118,17/05/2021 18:17:23,17/05/2021 18:17:33,18/05/2021 00:06:02,18/05/2021 07:21:16,2880271,2900670,20399,783
6118,17/05/2021 18:17:23,17/05/2021 18:17:33,18/05/2021 00:06:02,18/05/2021 07:21:16,2880271,2900670,20399,783
6118,17/05/2021 18:17:23,17/05/2021 18:17:33,18/05/2021 00:06:02,18/05/2021 07:21:16,2880271,2900670,20399,783
6118,17/05/2021 18:17:23,17/05/2021 18:17:33,18/05/2021 00:06:02,18/05/2021 07:21:16,2880271,2900670,20399,783
6130,18/05/2021 09:44:08,18/05/2021 09:44:12,18/05/2021 10:08:44,18/05/2021 10:08:48,170123,171517,1394,24
6137,18/05/2021 12:13:33,18/05/2021 12:14:28,18/05/2021 15:27:12,18/05/2021 15:32:47,109489,120685,11196,199
6133,17/05/2021 21:28:00,17/05/2021 21:28:01,18/05/2021 06:23:26,18/05/2021 12:45:57,533288,564385,31097,917
6118,18/05/2021 07:36:40,18/05/2021 07:36:44,18/05/2021 10:53:17,18/05/2021 12:57:05,2900671,2908996,8325,320
6193,18/05/2021 08:31:31,18/05/2021 08:31:35,18/05/2021 10:43:21,18/05/2021 13:55:57,432632,439725,7093,324
6106,18/05/2021 14:10:10,18/05/2021 14:10:17,18/05/2021 15:52:31,18/05/2021 15:52:34,168214,174101,5887,102
6103,18/05/2021 16:43:10,18/05/2021 16:43:11,18/05/2021 17:02:44,18/05/2021 17:02:47,170025,171113,1088,19
6121,18/05/2021 17:31:17,18/05/2021 17:31:18,18/05/2021 20:09:08,18/05/2021 20:14:40,212238,219619,7381,163
6189,18/05/2021 16:49:54,18/05/2021 16:49:56,18/05/2021 18:32:57,18/05/2021 18:32:59,276970425,276976234,5809,103
6155,18/05/2021 16:01:01,18/05/2021 16:01:02,18/05/2021 19:42:17,18/05/2021 19:42:19,111946,116123,4177,221
6132,18/05/2021 20:14:10,18/05/2021 20:14:11,18/05/2021 20:15:08,18/05/2021 20:15:15,3623917,3623968,51,1
6132,18/05/2021 20:15:48,18/05/2021 20:15:49,19/05/2021 04:00:34,19/05/2021 06:59:34,3623968,3648827,24859,643
6189,18/05/2021 19:04:17,18/05/2021 19:04:19,19/05/2021 04:53:31,19/05/2021 04:53:34,276976235,276991855,15620,589
6115,18/05/2021 16:41:19,18/05/2021 16:41:23,18/05/2021 22:21:18,19/05/2021 07:11:05,533531,551547,18016,869
6178,18/05/2021 10:06:49,18/05/2021 10:06:53,19/05/2021 00:04:18,19/05/2021 07:31:37,286581022,286604741,23719,1284
6168,18/05/2021 17:59:30,18/05/2021 17:59:32,19/05/2021 09:42:58,19/05/2021 09:43:01,273836132,273846384,10252,943
6123,19/05/2021 12:16:42,19/05/2021 12:16:43,19/05/2021 14:33:01,19/05/2021 14:33:13,237260,245559,8299,136
6178,19/05/2021 07:33:44,19/05/2021 07:33:50,19/05/2021 11:55:05,19/05/2021 15:05:20,286604741,286612093,7352,451
6142,19/05/2021 16:19:45,19/05/2021 16:19:46,19/05/2021 16:37:43,19/05/2021 16:37:52,675093,676126,1033,18
6189,19/05/2021 15:51:57,19/05/2021 15:51:59,19/05/2021 16:38:48,19/05/2021 16:38:50,276991876,276994467,2591,46
6148,19/05/2021 18:11:34,19/05/2021 18:11:35,19/05/2021 20:55:52,19/05/2021 21:23:03,237632,245100,7468,191
6132,19/05/2021 19:16:35,19/05/2021 19:16:41,20/05/2021 08:33:01,20/05/2021 08:49:32,3648852,3693967,45115,812
6189,19/05/2021 17:02:40,19/05/2021 17:02:42,20/05/2021 04:46:20,20/05/2021 04:46:22,276994468,277020175,25707,703
6136,19/05/2021 15:13:23,19/05/2021 15:13:25,20/05/2021 09:32:55,20/05/2021 09:32:57,1884158,1943684,59526,1099
6118,20/05/2021 07:36:50,20/05/2021 07:36:54,20/05/2021 10:26:25,20/05/2021 12:15:45,2909083,2915868,6785,278
6116,20/05/2021 14:03:14,20/05/2021 14:03:15,20/05/2021 15:56:47,20/05/2021 16:02:59,673741,680055,6314,119
6168,20/05/2021 18:20:18,20/05/2021 18:20:19,20/05/2021 20:32:00,20/05/2021 20:32:09,273846453,273854290,7837,131
6184,20/05/2021 18:51:31,20/05/2021 18:51:32,21/05/2021 04:52:11,21/05/2021 04:52:13,957801,992744,34943,600
6151,20/05/2021 17:08:59,20/05/2021 17:09:00,21/05/2021 06:43:44,21/05/2021 06:43:51,102808518,102856422,47904,814
6189,20/05/2021 14:39:56,20/05/2021 14:39:58,20/05/2021 22:21:47,21/05/2021 06:48:32,277020195,277043509,23314,968
6189,20/05/2021 14:39:56,20/05/2021 14:39:58,20/05/2021 22:21:47,21/05/2021 06:48:32,277020195,277043509,23314,968
6189,20/05/2021 14:39:56,20/05/2021 14:39:58,20/05/2021 22:21:47,21/05/2021 06:48:32,277020195,277043509,23314,968
6189,20/05/2021 14:39:56,20/05/2021 14:39:58,20/05/2021 22:21:47,21/05/2021 06:48:32,277020195,277043509,23314,968
6175,20/05/2021 16:05:22,20/05/2021 16:05:27,20/05/2021 22:39:19,21/05/2021 06:54:12,275217125,275236285,19160,888
6132,20/05/2021 19:43:47,20/05/2021 19:43:48,21/05/2021 05:07:39,21/05/2021 06:56:51,3693989,3724316,30327,673
6142,20/05/2021 19:57:41,20/05/2021 19:57:42,21/05/2021 01:37:00,21/05/2021 07:21:32,676195,692177,15982,683
6136,21/05/2021 13:51:11,21/05/2021 13:51:15,21/05/2021 16:47:12,21/05/2021 16:48:20,1943749,1954791,11042,177
6109,21/05/2021 14:22:53,21/05/2021 14:22:55,21/05/2021 15:35:49,21/05/2021 15:35:57,331557,335432,3875,73
6136,21/05/2021 16:48:37,21/05/2021 16:48:42,21/05/2021 17:14:29,21/05/2021 17:14:52,1954791,1956384,1593,26
6136,21/05/2021 17:18:18,21/05/2021 17:18:21,21/05/2021 17:59:50,21/05/2021 18:00:33,1956384,1958948,2564,42
6109,21/05/2021 17:31:37,21/05/2021 17:31:38,21/05/2021 20:33:32,21/05/2021 20:40:28,335437,343869,8432,188
6133,21/05/2021 21:01:50,21/05/2021 21:01:52,21/05/2021 21:53:43,21/05/2021 21:53:46,564580,567741,3161,51
6189,13/04/2021 15:30:34,13/04/2021 15:30:36,14/04/2021 05:42:14,14/04/2021 05:42:16,276376802,276408064,31262,851
6118,21/05/2021 16:37:42,21/05/2021 16:37:59,22/05/2021 00:06:02,22/05/2021 05:57:35,2915899,2942085,26186,799
6177,21/05/2021 19:29:46,21/05/2021 19:29:51,22/05/2021 04:27:31,22/05/2021 07:46:02,87824,118644,30820,736
6123,22/05/2021 10:02:35,22/05/2021 10:02:36,22/05/2021 14:06:57,22/05/2021 14:35:06,245712,260515,14803,272
6151,22/05/2021 07:04:43,22/05/2021 07:04:49,22/05/2021 15:09:24,22/05/2021 15:09:24,102856510,102882507,25997,484
6150,22/05/2021 14:29:58,22/05/2021 14:30:03,22/05/2021 15:33:39,22/05/2021 15:33:47,160301,163873,3572,63
6178,22/05/2021 07:24:26,22/05/2021 07:26:20,22/05/2021 16:31:13,22/05/2021 16:35:13,286612221,286641637,29416,550
6168,22/05/2021 09:04:11,22/05/2021 09:04:14,22/05/2021 17:01:14,22/05/2021 17:01:22,273854364,273882002,27638,477
6118,22/05/2021 14:42:20,22/05/2021 14:42:36,22/05/2021 18:11:53,22/05/2021 19:31:06,2942097,2953801,11704,288
6136,22/05/2021 08:38:44,22/05/2021 08:38:45,22/05/2021 21:04:48,22/05/2021 21:11:29,1958982,2006809,47827,752
6132,21/05/2021 22:47:22,21/05/2021 22:47:23,22/05/2021 05:53:59,22/05/2021 21:44:37,3724348,3746987,22639,1377
6184,22/05/2021 17:00:08,22/05/2021 17:00:15,23/05/2021 06:52:02,23/05/2021 06:52:06,992819,1018529,25710,831
6184,22/05/2021 17:00:08,22/05/2021 17:00:15,23/05/2021 06:52:02,23/05/2021 06:52:06,992819,1018529,25710,831
6184,22/05/2021 17:00:08,22/05/2021 17:00:15,23/05/2021 06:52:02,23/05/2021 06:52:06,992819,1018529,25710,831
6184,22/05/2021 17:00:08,22/05/2021 17:00:15,23/05/2021 06:52:02,23/05/2021 06:52:06,992819,1018529,25710,831
6188,22/05/2021 08:47:32,22/05/2021 08:47:33,22/05/2021 23:24:07,23/05/2021 07:47:09,274407205,274455895,48690,1379
6101,23/05/2021 09:03:05,23/05/2021 09:03:11,23/05/2021 10:51:25,23/05/2021 10:51:28,548517,554720,6203,108
6116,23/05/2021 11:06:49,23/05/2021 11:06:51,23/05/2021 13:45:11,23/05/2021 13:53:59,680190,690215,10025,167
6144,23/05/2021 11:38:39,23/05/2021 11:38:43,23/05/2021 16:23:32,23/05/2021 16:23:36,262794,279494,16700,284
6132,23/05/2021 17:20:26,23/05/2021 17:20:27,23/05/2021 18:51:53,23/05/2021 18:51:58,3747027,3752051,5024,91
6136,23/05/2021 12:54:39,23/05/2021 12:54:44,23/05/2021 19:16:13,23/05/2021 19:16:19,2006848,2030638,23790,381
6169,23/05/2021 15:46:18,23/05/2021 15:46:20,23/05/2021 18:34:22,23/05/2021 19:37:58,273345026,273351331,6305,231
6148,23/05/2021 17:45:18,23/05/2021 17:45:19,23/05/2021 20:13:56,23/05/2021 21:18:17,245358,252105,6747,212
6189,23/05/2021 17:39:47,23/05/2021 17:39:49,24/05/2021 05:05:31,24/05/2021 05:05:33,277060464,277086787,26323,685
6177,23/05/2021 14:28:26,23/05/2021 14:28:30,23/05/2021 23:19:39,24/05/2021 08:53:15,118707,149748,31041,1104
6138,24/05/2021 08:10:25,24/05/2021 08:10:27,24/05/2021 08:13:05,24/05/2021 10:40:15,421578,421634,56,149
6151,24/05/2021 13:07:18,24/05/2021 13:07:19,24/05/2021 15:06:10,24/05/2021 15:06:23,102882673,102889692,7019,119
6169,24/05/2021 17:21:16,24/05/2021 17:21:41,24/05/2021 20:27:17,24/05/2021 20:27:30,273351379,273362577,11198,186
6155,24/05/2021 16:31:27,24/05/2021 16:31:28,24/05/2021 20:58:10,24/05/2021 20:58:12,116414,121434,5020,266
6189,15/04/2021 15:33:02,15/04/2021 15:33:04,16/04/2021 06:49:36,16/04/2021 06:49:38,276436131,276467618,31487,916
6132,24/05/2021 20:44:05,24/05/2021 20:44:06,25/05/2021 04:31:52,25/05/2021 06:57:55,3752103,3776876,24773,613
6136,24/05/2021 16:58:42,24/05/2021 16:58:48,25/05/2021 00:15:26,25/05/2021 07:08:10,2030695,2057413,26718,849
6147,25/05/2021 07:42:22,25/05/2021 07:42:27,25/05/2021 11:02:15,25/05/2021 11:05:52,398732,407122,8390,203
6147,25/05/2021 07:42:22,25/05/2021 07:42:27,25/05/2021 11:02:15,25/05/2021 11:05:52,398732,407122,8390,203
6147,25/05/2021 07:42:22,25/05/2021 07:42:27,25/05/2021 11:02:15,25/05/2021 11:05:52,398732,407122,8390,203
6147,25/05/2021 07:42:22,25/05/2021 07:42:27,25/05/2021 11:02:15,25/05/2021 11:05:52,398732,407122,8390,203
6138,25/05/2021 06:47:12,25/05/2021 06:47:19,25/05/2021 10:30:56,25/05/2021 11:22:56,421680,433814,12134,275
6148,25/05/2021 17:46:52,25/05/2021 17:46:53,25/05/2021 20:34:13,25/05/2021 20:43:22,252232,259541,7309,176
6189,25/05/2021 16:03:48,25/05/2021 16:03:50,26/05/2021 04:52:13,26/05/2021 04:52:15,277112065,277134439,22374,768
6132,25/05/2021 18:26:50,25/05/2021 18:26:51,26/05/2021 02:29:00,26/05/2021 07:05:11,3776898,3802576,25678,758
6151,25/05/2021 19:39:54,25/05/2021 19:39:55,26/05/2021 07:48:01,26/05/2021 07:48:04,102889795,102932708,42913,728
6168,25/05/2021 18:13:51,25/05/2021 18:13:52,26/05/2021 08:38:31,26/05/2021 08:38:51,273882162,273892535,10373,865
6138,26/05/2021 08:28:58,26/05/2021 08:29:06,26/05/2021 10:32:45,26/05/2021 13:23:13,433858,440254,6396,294
6189,26/05/2021 15:03:46,26/05/2021 15:03:47,26/05/2021 15:04:06,26/05/2021 15:04:08,277134460,277134473,13,0
6123,26/05/2021 09:40:07,26/05/2021 09:40:08,26/05/2021 13:09:21,26/05/2021 15:47:12,260737,273399,12662,367
6109,26/05/2021 15:18:34,26/05/2021 15:18:35,26/05/2021 17:34:14,26/05/2021 17:34:18,344182,352174,7992,135
6109,26/05/2021 18:03:51,26/05/2021 18:03:52,26/05/2021 18:46:22,26/05/2021 18:46:39,352175,353921,1746,42
6148,26/05/2021 17:53:57,26/05/2021 17:54:29,26/05/2021 20:40:25,26/05/2021 21:14:30,259601,266869,7268,200
6155,26/05/2021 16:07:29,26/05/2021 16:07:31,26/05/2021 21:17:35,26/05/2021 21:17:37,121524,127401,5877,310
6189,26/05/2021 15:04:32,26/05/2021 15:04:34,27/05/2021 04:54:59,27/05/2021 04:55:01,277134473,277161475,27002,830
6138,26/05/2021 19:36:14,26/05/2021 19:36:16,27/05/2021 05:56:46,27/05/2021 05:56:51,440267,476283,36016,620
6151,26/05/2021 19:56:44,26/05/2021 19:56:45,27/05/2021 06:41:52,27/05/2021 06:42:43,102932739,102966310,33571,645
6132,26/05/2021 22:18:59,26/05/2021 22:19:01,27/05/2021 05:10:53,27/05/2021 07:05:28,3802607,3824508,21901,526
6115,26/05/2021 16:38:23,26/05/2021 16:38:27,26/05/2021 21:56:48,27/05/2021 07:41:35,552004,568927,16923,903
6143,27/05/2021 07:22:22,27/05/2021 07:22:25,27/05/2021 08:53:31,27/05/2021 08:53:36,1493152,1497419,4267,91
6118,27/05/2021 07:40:12,27/05/2021 07:40:16,27/05/2021 11:05:03,27/05/2021 13:38:36,2953991,2962171,8180,358
6136,27/05/2021 12:36:12,27/05/2021 12:36:14,27/05/2021 17:02:43,27/05/2021 17:02:45,2057543,2072005,14462,266
6179,27/05/2021 14:02:03,27/05/2021 14:02:12,27/05/2021 17:29:45,27/05/2021 17:29:59,274741473,274752978,11505,207
6150,27/05/2021 17:41:58,27/05/2021 17:42:02,27/05/2021 20:21:29,27/05/2021 20:21:32,164139,173995,9856,159
6150,27/05/2021 17:41:58,27/05/2021 17:42:02,27/05/2021 20:21:29,27/05/2021 20:21:32,164139,173995,9856,159
6150,27/05/2021 17:41:58,27/05/2021 17:42:02,27/05/2021 20:21:29,27/05/2021 20:21:32,164139,173995,9856,159
6150,27/05/2021 17:41:58,27/05/2021 17:42:02,27/05/2021 20:21:29,27/05/2021 20:21:32,164139,173995,9856,159
6136,27/05/2021 19:31:01,27/05/2021 19:31:02,27/05/2021 21:58:29,27/05/2021 21:58:35,2072011,2081381,9370,147
6116,27/05/2021 19:55:44,27/05/2021 19:55:59,27/05/2021 23:16:40,27/05/2021 23:19:37,690421,701813,11392,203
6116,27/05/2021 19:55:44,27/05/2021 19:55:59,27/05/2021 23:16:40,27/05/2021 23:19:37,690421,701813,11392,203
6116,27/05/2021 19:55:44,27/05/2021 19:55:59,27/05/2021 23:16:40,27/05/2021 23:19:37,690421,701813,11392,203
6116,27/05/2021 19:55:44,27/05/2021 19:55:59,27/05/2021 23:16:40,27/05/2021 23:19:37,690421,701813,11392,203
6189,27/05/2021 17:23:30,27/05/2021 17:23:32,28/05/2021 05:23:22,28/05/2021 05:23:24,277161500,277190081,28581,719
6132,27/05/2021 19:59:58,27/05/2021 19:59:59,28/05/2021 01:51:01,28/05/2021 07:11:23,3824534,3842760,18226,671
6132,27/05/2021 19:59:58,27/05/2021 19:59:59,28/05/2021 01:51:01,28/05/2021 07:11:23,3824534,3842760,18226,671
6132,27/05/2021 19:59:58,27/05/2021 19:59:59,28/05/2021 01:51:01,28/05/2021 07:11:23,3824534,3842760,18226,671
6132,27/05/2021 19:59:58,27/05/2021 19:59:59,28/05/2021 01:51:01,28/05/2021 07:11:23,3824534,3842760,18226,671
6168,28/05/2021 08:23:53,28/05/2021 08:23:56,28/05/2021 11:44:24,28/05/2021 11:44:51,273892635,273904208,11573,200
6108,28/05/2021 12:24:09,28/05/2021 12:24:19,28/05/2021 15:53:15,28/05/2021 15:53:15,117223,129753,12530,209
6175,28/05/2021 14:38:55,28/05/2021 14:38:57,28/05/2021 15:57:07,28/05/2021 15:57:09,275236635,275241018,4383,78
6108,28/05/2021 16:01:00,28/05/2021 16:01:08,28/05/2021 16:01:30,28/05/2021 16:01:30,129754,129772,18,0
6119,28/05/2021 07:12:37,28/05/2021 07:12:38,28/05/2021 17:17:52,28/05/2021 17:17:54,990124,1026007,35883,605
6169,28/05/2021 13:57:29,28/05/2021 13:57:32,28/05/2021 15:09:12,28/05/2021 18:18:58,273362774,273364038,1264,261
6136,28/05/2021 19:25:28,28/05/2021 19:25:29,28/05/2021 20:44:55,28/05/2021 20:45:05,2081432,2086494,5062,79
6143,28/05/2021 19:46:35,28/05/2021 19:46:36,28/05/2021 21:33:02,28/05/2021 21:36:24,1497496,1502683,5187,109
6136,29/05/2021 03:23:13,29/05/2021 03:23:15,29/05/2021 08:55:02,29/05/2021 09:10:23,2086511,2104454,17943,347
6132,28/05/2021 21:34:33,28/05/2021 21:34:34,29/05/2021 01:06:05,29/05/2021 09:13:25,3842789,3852812,10023,698
6130,29/05/2021 09:01:55,29/05/2021 09:01:57,29/05/2021 11:03:46,29/05/2021 11:30:33,172233,178632,6399,148
6169,29/05/2021 10:20:23,29/05/2021 10:20:32,29/05/2021 16:08:51,29/05/2021 16:11:58,273364074,273384641,20567,351
6172,29/05/2021 15:58:49,29/05/2021 15:58:51,29/05/2021 16:23:23,29/05/2021 16:23:29,304709517,304710964,1447,24
6185,29/05/2021 16:21:16,29/05/2021 16:21:23,29/05/2021 16:59:53,29/05/2021 16:59:56,285315639,285317718,2079,38
6109,29/05/2021 15:24:44,29/05/2021 15:24:45,29/05/2021 18:17:11,29/05/2021 18:46:10,354113,362396,8283,201
6107,29/05/2021 17:14:07,29/05/2021 17:14:09,29/05/2021 20:04:48,29/05/2021 20:04:58,501623,511668,10045,170
6136,29/05/2021 17:20:24,29/05/2021 17:20:25,29/05/2021 21:15:58,29/05/2021 21:16:00,2104473,2117854,13381,235
6170,29/05/2021 21:38:14,29/05/2021 21:38:15,30/05/2021 06:40:43,30/05/2021 06:40:45,120745,154139,33394,542
6136,29/05/2021 21:26:51,29/05/2021 21:26:53,30/05/2021 08:48:18,30/05/2021 08:48:36,2117854,2161221,43367,681
6189,29/05/2021 18:12:50,29/05/2021 18:12:51,30/05/2021 04:25:18,30/05/2021 09:32:14,277190153,277222427,32274,919
6188,30/05/2021 12:46:43,30/05/2021 12:46:47,30/05/2021 13:30:42,30/05/2021 13:31:21,274456300,274458676,2376,44
6136,30/05/2021 08:59:38,30/05/2021 08:59:40,30/05/2021 16:45:25,30/05/2021 16:45:27,2161222,2188834,27612,465
6170,30/05/2021 13:55:51,30/05/2021 13:55:52,30/05/2021 17:19:47,30/05/2021 17:19:54,154154,166541,12387,204
6115,30/05/2021 11:00:40,30/05/2021 11:00:44,30/05/2021 16:25:38,30/05/2021 19:23:58,569112,586574,17462,503
6151,30/05/2021 11:06:52,30/05/2021 11:06:53,30/05/2021 20:17:29,30/05/2021 20:17:38,102966498,102999060,32562,550
6132,29/05/2021 15:54:24,29/05/2021 15:54:25,29/05/2021 20:15:50,30/05/2021 22:16:26,3852826,3865601,12775,1822
6170,30/05/2021 20:45:34,30/05/2021 20:45:35,31/05/2021 05:39:05,31/05/2021 05:39:10,166549,199142,32593,533
6151,30/05/2021 22:07:08,30/05/2021 22:07:09,31/05/2021 06:25:55,31/05/2021 06:25:58,102999065,103017043,17978,498
6184,30/05/2021 12:32:17,30/05/2021 12:32:23,30/05/2021 20:41:44,31/05/2021 08:10:43,1018893,1048033,29140,1178
6184,30/05/2021 12:32:17,30/05/2021 12:32:23,30/05/2021 20:41:44,31/05/2021 08:10:43,1018893,1048033,29140,1178
6184,30/05/2021 12:32:17,30/05/2021 12:32:23,30/05/2021 20:41:44,31/05/2021 08:10:43,1018893,1048033,29140,1178
6184,30/05/2021 12:32:17,30/05/2021 12:32:23,30/05/2021 20:41:44,31/05/2021 08:10:43,1018893,1048033,29140,1178
6132,31/05/2021 08:05:35,31/05/2021 08:05:36,31/05/2021 08:30:29,31/05/2021 08:30:33,3865621,3866898,1277,24
6188,31/05/2021 07:56:33,31/05/2021 07:56:37,31/05/2021 11:33:54,31/05/2021 12:25:32,274458720,274468086,9366,268
6189,31/05/2021 13:52:16,31/05/2021 13:52:18,31/05/2021 15:42:22,31/05/2021 15:42:24,277222482,277228684,6202,110
6138,31/05/2021 10:28:35,31/05/2021 10:28:43,31/05/2021 14:00:02,31/05/2021 17:19:38,476513,488017,11504,411
6122,31/05/2021 13:13:09,31/05/2021 13:13:15,31/05/2021 15:19:47,31/05/2021 17:53:59,67423,67423,0,280
6170,31/05/2021 21:18:20,31/05/2021 21:18:21,01/06/2021 04:32:08,01/06/2021 04:32:13,199173,225819,26646,433
6107,31/05/2021 14:23:13,31/05/2021 14:23:15,01/06/2021 06:43:56,01/06/2021 06:45:05,511774,569096,57322,981
6136,31/05/2021 19:19:02,31/05/2021 19:19:03,01/06/2021 07:21:55,01/06/2021 07:22:22,2188897,2235052,46155,723
6118,01/06/2021 10:32:19,01/06/2021 10:32:21,01/06/2021 11:05:30,01/06/2021 11:05:35,2962308,2964363,2055,33
6132,01/06/2021 13:00:29,01/06/2021 13:00:30,01/06/2021 14:17:23,01/06/2021 14:17:25,3866955,3871228,4273,76
6109,01/06/2021 15:30:11,01/06/2021 15:30:13,01/06/2021 18:24:02,01/06/2021 18:58:57,362589,371092,8503,208
6151,01/06/2021 15:38:51,01/06/2021 15:38:53,01/06/2021 19:30:40,01/06/2021 19:30:42,103017120,103029157,12037,231
6155,01/06/2021 18:32:14,01/06/2021 18:32:15,01/06/2021 22:03:01,01/06/2021 22:03:03,127695,131689,3994,210
6189,01/06/2021 16:24:06,01/06/2021 16:24:08,02/06/2021 05:07:23,02/06/2021 05:07:25,277228732,277261874,33142,763
6101,01/06/2021 22:46:36,01/06/2021 22:46:38,02/06/2021 05:20:11,02/06/2021 05:20:14,555222,578036,22814,393
6177,01/06/2021 18:46:52,01/06/2021 18:46:56,02/06/2021 00:16:30,02/06/2021 05:42:05,150157,169518,19361,655
6170,01/06/2021 18:32:54,01/06/2021 18:32:55,02/06/2021 05:22:31,02/06/2021 05:43:31,225847,262604,36757,670
6132,01/06/2021 17:32:05,01/06/2021 17:32:06,02/06/2021 03:19:44,02/06/2021 07:05:40,3871234,3903464,32230,813
6137,01/06/2021 14:56:25,01/06/2021 14:56:28,02/06/2021 08:12:39,02/06/2021 08:12:41,121302,183448,62146,1036
6179,02/06/2021 09:39:50,02/06/2021 09:39:57,02/06/2021 10:42:21,02/06/2021 10:42:24,274753265,274756657,3392,62
6179,02/06/2021 09:39:50,02/06/2021 09:39:57,02/06/2021 10:42:21,02/06/2021 10:42:24,274753265,274756657,3392,62
6179,02/06/2021 09:39:50,02/06/2021 09:39:57,02/06/2021 10:42:21,02/06/2021 10:42:24,274753265,274756657,3392,62
6179,02/06/2021 09:39:50,02/06/2021 09:39:57,02/06/2021 10:42:21,02/06/2021 10:42:24,274753265,274756657,3392,62
6118,02/06/2021 08:42:18,02/06/2021 08:42:27,02/06/2021 11:22:04,02/06/2021 11:34:37,2964409,2973348,8939,172
6132,02/06/2021 16:51:11,02/06/2021 16:51:12,02/06/2021 19:42:46,02/06/2021 19:42:55,3903483,3913291,9808,171
6136,02/06/2021 15:55:30,02/06/2021 15:55:32,02/06/2021 20:28:01,02/06/2021 20:28:03,2235132,2251060,15928,272
6189,02/06/2021 16:15:49,02/06/2021 16:15:51,03/06/2021 00:33:58,03/06/2021 05:14:25,277261895,277287866,25971,778
6170,02/06/2021 19:58:56,02/06/2021 19:58:57,03/06/2021 05:27:21,03/06/2021 05:27:26,262632,297605,34973,568
6116,02/06/2021 07:24:49,02/06/2021 07:24:51,02/06/2021 10:53:54,03/06/2021 06:47:30,702070,715238,13168,1402
6138,02/06/2021 19:48:34,02/06/2021 19:48:36,03/06/2021 07:30:32,03/06/2021 07:30:35,488122,528995,40873,702
6175,03/06/2021 17:36:10,03/06/2021 17:37:08,03/06/2021 17:37:18,03/06/2021 17:37:54,275241308,275241308,0,1
6109,03/06/2021 16:24:55,03/06/2021 16:24:56,03/06/2021 17:51:09,03/06/2021 17:51:29,371223,375869,4646,86
6175,03/06/2021 17:38:12,03/06/2021 17:39:27,03/06/2021 19:07:57,03/06/2021 19:13:48,275241308,275241315,7,95
6138,03/06/2021 13:52:38,03/06/2021 13:52:44,03/06/2021 15:57:10,03/06/2021 19:29:25,529010,535581,6571,336
6189,03/06/2021 15:38:18,03/06/2021 15:38:20,03/06/2021 22:32:27,04/06/2021 05:10:49,277287886,277308933,21047,812
6170,03/06/2021 20:09:58,03/06/2021 20:09:59,04/06/2021 05:12:27,04/06/2021 05:12:32,297635,329269,31634,542
6132,03/06/2021 19:00:37,03/06/2021 19:00:38,04/06/2021 01:14:27,04/06/2021 07:09:38,3913337,3932928,19591,729
6175,03/06/2021 19:14:50,03/06/2021 19:14:51,04/06/2021 00:31:32,04/06/2021 07:44:01,275241315,275252787,11472,749
6150,04/06/2021 14:18:18,04/06/2021 14:18:22,04/06/2021 15:34:14,04/06/2021 15:34:56,174401,179141,4740,76
6159,04/06/2021 15:03:11,04/06/2021 15:03:19,04/06/2021 17:31:48,04/06/2021 17:31:52,37082,45112,8030,148
6132,04/06/2021 17:51:53,04/06/2021 17:51:56,04/06/2021 21:04:36,04/06/2021 21:04:38,1202981,1214474,11493,192
6170,04/06/2021 18:28:42,04/06/2021 18:28:42,05/06/2021 04:29:56,05/06/2021 04:30:04,329295,366245,36950,601
6138,04/06/2021 00:30:57,04/06/2021 00:30:59,04/06/2021 16:19:57,05/06/2021 05:40:07,535592,590600,55008,1749
6184,04/06/2021 13:59:18,04/06/2021 13:59:35,05/06/2021 08:13:21,05/06/2021 08:13:56,1048242,1073800,25558,1094
6136,05/06/2021 08:41:02,05/06/2021 08:41:06,05/06/2021 08:43:36,05/06/2021 08:44:47,2251198,2251340,142,3
6132,04/06/2021 21:03:44,04/06/2021 21:03:49,05/06/2021 09:39:37,05/06/2021 09:39:41,3932956,3954704,21748,755
6189,04/06/2021 16:07:03,04/06/2021 16:07:06,05/06/2021 01:01:45,05/06/2021 10:19:11,277308954,277336695,27741,1092
6169,05/06/2021 11:46:34,05/06/2021 11:46:35,05/06/2021 11:47:04,05/06/2021 11:48:00,273385000,273385018,18,1
6136,05/06/2021 08:44:52,05/06/2021 08:44:57,05/06/2021 13:15:21,05/06/2021 13:16:17,2251340,2267799,16459,271
6169,05/06/2021 11:48:19,05/06/2021 11:48:21,05/06/2021 13:49:54,05/06/2021 13:49:56,273385018,273391279,6261,121
6170,05/06/2021 10:29:31,05/06/2021 10:29:32,05/06/2021 14:26:41,05/06/2021 14:26:43,366257,380764,14507,237
6187,05/06/2021 14:58:34,05/06/2021 14:58:36,05/06/2021 16:14:35,05/06/2021 16:14:37,78069,82213,4144,76
6178,05/06/2021 08:08:22,05/06/2021 08:08:24,05/06/2021 16:08:05,05/06/2021 17:19:19,286642288,286668343,26055,550
6151,05/06/2021 12:04:18,05/06/2021 12:04:19,05/06/2021 23:24:29,05/06/2021 23:24:34,103029368,103069825,40457,680
6170,05/06/2021 20:07:37,05/06/2021 20:07:38,06/06/2021 05:46:40,06/06/2021 05:46:42,380776,416425,35649,579
6107,05/06/2021 14:03:16,05/06/2021 14:03:18,06/06/2021 09:57:12,06/06/2021 09:57:35,569377,637578,68201,1194
6144,05/06/2021 14:31:08,05/06/2021 14:31:10,06/06/2021 00:13:24,06/06/2021 12:33:45,280378,315151,34773,1322
6144,05/06/2021 14:31:08,05/06/2021 14:31:10,06/06/2021 00:13:24,06/06/2021 12:33:45,280378,315151,34773,1322
6144,05/06/2021 14:31:08,05/06/2021 14:31:10,06/06/2021 00:13:24,06/06/2021 12:33:45,280378,315151,34773,1322
6136,05/06/2021 23:21:13,05/06/2021 23:21:16,06/06/2021 12:52:01,06/06/2021 12:52:03,2267825,2311414,43589,810
6168,06/06/2021 16:58:57,06/06/2021 16:58:58,06/06/2021 18:39:48,06/06/2021 18:40:31,273904670,273910380,5710,101
6168,06/06/2021 16:58:57,06/06/2021 16:58:58,06/06/2021 18:39:48,06/06/2021 18:40:31,273904670,273910380,5710,101
6168,06/06/2021 16:58:57,06/06/2021 16:58:58,06/06/2021 18:39:48,06/06/2021 18:40:31,273904670,273910380,5710,101
6168,06/06/2021 16:58:57,06/06/2021 16:58:58,06/06/2021 18:39:48,06/06/2021 18:40:31,273904670,273910380,5710,101
6189,06/06/2021 16:13:50,06/06/2021 16:13:52,06/06/2021 18:47:27,06/06/2021 19:17:28,277336752,277343313,6561,183
6184,06/06/2021 13:33:56,06/06/2021 13:33:57,07/06/2021 05:31:39,07/06/2021 05:31:41,1073860,1131005,57145,957
6170,06/06/2021 20:03:07,06/06/2021 20:03:08,07/06/2021 05:41:30,07/06/2021 05:41:34,416454,452124,35670,578
6132,05/06/2021 21:30:06,05/06/2021 21:30:07,06/06/2021 05:59:24,07/06/2021 07:00:31,3954728,3982905,28177,2010
6116,06/06/2021 17:25:15,06/06/2021 17:25:18,06/06/2021 20:49:32,07/06/2021 07:08:34,715403,728243,12840,823
6138,05/06/2021 11:39:06,05/06/2021 11:39:13,05/06/2021 13:42:02,07/06/2021 10:12:19,590614,597150,6536,2793
6132,07/06/2021 08:21:04,07/06/2021 08:21:06,07/06/2021 10:42:38,07/06/2021 10:43:04,3982908,3990728,7820,142
6147,07/06/2021 10:22:02,07/06/2021 10:22:03,07/06/2021 13:35:12,07/06/2021 13:35:16,407967,418200,10233,193
6132,07/06/2021 17:43:49,07/06/2021 17:43:50,07/06/2021 19:57:17,07/06/2021 19:58:55,3990742,3998230,7488,135
6169,07/06/2021 17:35:34,07/06/2021 17:35:37,07/06/2021 20:16:54,07/06/2021 20:16:54,273391397,273400308,8911,161
6109,07/06/2021 15:39:09,07/06/2021 15:39:09,07/06/2021 18:33:14,07/06/2021 21:00:07,376134,384369,8235,320
6155,07/06/2021 15:58:02,07/06/2021 15:58:03,07/06/2021 21:29:16,07/06/2021 21:29:18,135080,141362,6282,331
6119,07/06/2021 20:15:34,07/06/2021 20:15:38,08/06/2021 02:27:12,08/06/2021 02:45:17,1026637,1049660,23023,389
6189,07/06/2021 16:19:46,07/06/2021 16:19:48,07/06/2021 22:54:01,08/06/2021 04:54:26,277343353,277363082,19729,754
6170,07/06/2021 19:22:55,07/06/2021 19:22:58,07/06/2021 22:33:33,08/06/2021 07:52:58,452152,460704,8552,750
6138,07/06/2021 21:47:08,07/06/2021 21:47:10,08/06/2021 07:58:09,08/06/2021 07:58:12,597173,632704,35531,611
6137,07/06/2021 17:09:59,07/06/2021 17:10:00,08/06/2021 09:32:27,08/06/2021 09:42:52,183673,247923,64250,992
6118,08/06/2021 07:41:55,08/06/2021 07:41:58,08/06/2021 10:46:06,08/06/2021 11:50:10,2973630,2982060,8430,248
6148,08/06/2021 10:43:04,08/06/2021 10:43:05,08/06/2021 14:33:35,08/06/2021 14:33:37,267712,280823,13111,230
6170,08/06/2021 17:11:07,08/06/2021 17:11:10,08/06/2021 19:26:17,08/06/2021 19:26:19,460723,467869,7146,135
6143,08/06/2021 16:08:57,08/06/2021 16:09:01,08/06/2021 19:55:01,08/06/2021 19:55:34,1521220,1535229,14009,226
6143,08/06/2021 19:55:58,08/06/2021 19:55:58,08/06/2021 19:55:58,08/06/2021 19:56:02,1535229,1535229,0,0
6143,08/06/2021 19:56:22,08/06/2021 19:56:27,08/06/2021 20:13:52,08/06/2021 20:14:07,1535229,1536308,1079,17
6132,08/06/2021 20:25:44,08/06/2021 20:25:45,09/06/2021 02:11:46,09/06/2021 07:05:02,3998278,4016430,18152,639
6136,08/06/2021 15:02:12,08/06/2021 15:02:18,08/06/2021 23:12:52,09/06/2021 07:10:45,2311533,2341243,29710,968
6115,08/06/2021 17:12:02,08/06/2021 17:12:08,08/06/2021 22:43:36,09/06/2021 07:40:49,587100,605847,18747,868
6106,09/06/2021 08:36:44,09/06/2021 08:36:51,09/06/2021 12:33:09,09/06/2021 12:55:36,175484,188502,13018,258
6147,09/06/2021 07:44:35,09/06/2021 07:44:38,09/06/2021 10:56:39,09/06/2021 13:48:47,418319,426594,8275,364
6133,08/06/2021 21:42:28,08/06/2021 21:42:29,09/06/2021 15:31:42,09/06/2021 16:15:40,568811,631996,63185,1113
6193,09/06/2021 14:47:04,09/06/2021 14:47:09,09/06/2021 16:59:51,09/06/2021 18:26:09,440785,447988,7203,219
6155,09/06/2021 16:14:20,09/06/2021 16:14:22,09/06/2021 20:38:19,09/06/2021 21:30:10,141450,146438,4988,315
6170,09/06/2021 18:59:03,09/06/2021 18:59:04,10/06/2021 04:41:39,10/06/2021 04:41:46,467916,503647,35731,582
6189,09/06/2021 17:22:22,09/06/2021 17:22:24,10/06/2021 01:51:35,10/06/2021 04:59:16,277363151,277389621,26470,696
6110,09/06/2021 18:41:52,09/06/2021 18:41:54,09/06/2021 21:02:53,10/06/2021 07:11:13,95764,102130,6366,749
6106,09/06/2021 15:19:43,09/06/2021 15:19:51,09/06/2021 16:46:40,10/06/2021 07:47:00,188508,192946,4438,987
6138,09/06/2021 08:18:41,09/06/2021 08:18:44,10/06/2021 00:32:15,10/06/2021 12:59:11,632762,689810,57048,1720
6138,09/06/2021 08:18:41,09/06/2021 08:18:44,10/06/2021 00:32:15,10/06/2021 12:59:11,632762,689810,57048,1720
6169,10/06/2021 11:42:44,10/06/2021 11:42:46,10/06/2021 13:01:19,10/06/2021 18:15:49,273400450,273402957,2507,393
6169,10/06/2021 11:42:44,10/06/2021 11:42:46,10/06/2021 13:01:19,10/06/2021 18:15:49,273400450,273402957,2507,393
6155,10/06/2021 13:20:04,10/06/2021 13:20:05,10/06/2021 18:20:14,10/06/2021 18:20:20,146472,163684,17212,300
6170,10/06/2021 20:16:55,10/06/2021 20:16:56,11/06/2021 04:07:51,11/06/2021 04:07:56,503678,532632,28954,471
6189,10/06/2021 15:34:37,10/06/2021 15:34:39,10/06/2021 23:11:43,11/06/2021 04:49:57,277389641,277413058,23417,795
6118,10/06/2021 19:12:14,10/06/2021 19:12:46,11/06/2021 00:48:04,11/06/2021 05:39:51,2982121,3000633,18512,627
6132,10/06/2021 20:15:02,10/06/2021 20:15:02,11/06/2021 03:56:48,11/06/2021 07:06:37,4016504,4041169,24665,651
6179,11/06/2021 10:11:40,11/06/2021 10:11:48,11/06/2021 10:27:04,11/06/2021 10:27:07,274757100,274757944,844,15
6107,10/06/2021 16:53:09,10/06/2021 16:53:11,11/06/2021 11:31:26,11/06/2021 13:13:26,637821,703366,65545,1220
6168,11/06/2021 10:01:29,11/06/2021 10:01:33,11/06/2021 15:02:38,11/06/2021 15:02:42,273910609,273927966,17357,301
6136,11/06/2021 15:50:18,11/06/2021 15:50:22,11/06/2021 17:22:05,11/06/2021 17:22:10,2341372,2347084,5712,91
6123,11/06/2021 11:59:53,11/06/2021 11:59:54,11/06/2021 16:12:51,11/06/2021 16:19:25,274334,289692,15358,259
6178,11/06/2021 16:42:54,11/06/2021 16:42:56,11/06/2021 17:12:56,11/06/2021 17:12:58,286668627,286670220,1593,30
6169,11/06/2021 17:14:53,11/06/2021 17:14:55,11/06/2021 17:29:32,11/06/2021 17:29:34,273403008,273403816,808,14
6169,11/06/2021 17:30:04,11/06/2021 17:30:05,11/06/2021 20:50:51,11/06/2021 20:50:53,273403816,273414944,11128,200
6151,11/06/2021 17:41:20,11/06/2021 17:41:22,11/06/2021 19:36:36,11/06/2021 19:36:38,103070252,103076851,6599,115
6109,11/06/2021 17:03:01,11/06/2021 17:03:02,11/06/2021 19:47:14,11/06/2021 20:37:33,384632,392410,7778,214
6175,11/06/2021 20:50:09,11/06/2021 20:50:13,12/06/2021 00:33:19,12/06/2021 12:48:40,275253145,275265979,12834,958
6132,11/06/2021 22:48:26,11/06/2021 22:48:28,12/06/2021 07:48:04,12/06/2021 23:30:07,4041200,4070690,29490,1481
6170,11/06/2021 18:08:32,11/06/2021 18:08:33,12/06/2021 00:58:06,12/06/2021 06:16:59,532660,554169,21509,728
6184,11/06/2021 15:37:46,11/06/2021 15:37:52,12/06/2021 06:28:53,12/06/2021 06:29:02,1131223,1165143,33920,891
6184,11/06/2021 15:37:46,11/06/2021 15:37:52,12/06/2021 06:28:53,12/06/2021 06:29:02,1131223,1165143,33920,891
6169,12/06/2021 06:46:28,12/06/2021 06:46:30,12/06/2021 08:08:23,12/06/2021 08:55:19,273414967,273417568,2601,128
6185,12/06/2021 08:33:51,12/06/2021 08:33:52,12/06/2021 10:53:01,12/06/2021 10:53:03,285318428,285325974,7546,139
6189,11/06/2021 16:51:05,11/06/2021 16:51:07,12/06/2021 00:56:40,12/06/2021 08:42:57,277413081,277438198,25117,951
6130,12/06/2021 08:48:25,12/06/2021 08:48:26,12/06/2021 08:49:45,12/06/2021 08:49:53,179515,179551,36,1
6143,12/06/2021 08:55:57,12/06/2021 08:55:59,12/06/2021 09:33:37,12/06/2021 09:33:37,1536486,1538568,2082,37
6127,12/06/2021 10:30:11,12/06/2021 10:30:15,12/06/2021 10:46:44,12/06/2021 10:46:44,237271,238307,1036,16
6118,12/06/2021 08:33:03,12/06/2021 08:33:06,12/06/2021 11:25:03,12/06/2021 13:30:56,3000666,3008357,7691,297
6155,12/06/2021 15:01:31,12/06/2021 15:01:33,13/06/2021 04:53:25,13/06/2021 06:43:17,163777,211607,47830,941
6116,12/06/2021 10:50:21,12/06/2021 10:50:23,12/06/2021 14:16:26,12/06/2021 16:31:06,728491,741331,12840,340
6170,12/06/2021 17:52:53,12/06/2021 17:52:54,13/06/2021 05:07:44,13/06/2021 05:48:06,554192,592363,38171,715
6169,13/06/2021 08:34:21,13/06/2021 08:34:23,13/06/2021 14:14:17,13/06/2021 14:42:09,273417627,273431424,13797,367
6143,13/06/2021 10:33:33,13/06/2021 10:33:35,13/06/2021 10:42:55,13/06/2021 10:42:55,1538623,1539108,485,9
6123,13/06/2021 09:21:27,13/06/2021 09:21:28,13/06/2021 11:44:13,13/06/2021 11:44:15,289795,296342,6547,142
6136,13/06/2021 12:24:38,13/06/2021 12:24:42,13/06/2021 18:59:09,13/06/2021 19:08:22,2347187,2371565,24378,403
6106,13/06/2021 17:09:24,13/06/2021 17:09:33,13/06/2021 18:55:42,13/06/2021 18:55:55,193165,199028,5863,106
6189,13/06/2021 13:22:34,13/06/2021 13:22:40,13/06/2021 19:34:08,13/06/2021 19:34:38,277438253,277459432,21179,372
6132,13/06/2021 15:44:02,13/06/2021 15:44:04,13/06/2021 20:19:28,13/06/2021 20:19:41,4070722,4085935,15213,275
6170,13/06/2021 17:03:39,13/06/2021 17:03:40,14/06/2021 02:41:44,14/06/2021 04:46:38,592386,624723,32337,702
6184,13/06/2021 15:40:44,13/06/2021 15:40:45,14/06/2021 03:38:48,14/06/2021 04:49:07,1165211,1205941,40730,788
6189,13/06/2021 21:09:03,13/06/2021 21:09:05,14/06/2021 03:34:38,14/06/2021 05:07:40,277459435,277478783,19348,478
6136,13/06/2021 19:35:46,13/06/2021 19:35:47,14/06/2021 06:44:07,14/06/2021 06:44:09,2371566,2405398,33832,668
6132,14/06/2021 18:01:46,14/06/2021 18:01:47,14/06/2021 22:51:33,15/06/2021 07:10:25,4085978,4100125,14147,788
6189,14/06/2021 15:38:23,14/06/2021 15:38:25,14/06/2021 23:36:44,15/06/2021 04:53:44,277478803,277503431,24628,795
6189,14/06/2021 15:38:23,14/06/2021 15:38:25,14/06/2021 23:36:44,15/06/2021 04:53:44,277478803,277503431,24628,795
6170,14/06/2021 15:41:12,14/06/2021 15:41:14,15/06/2021 02:32:03,15/06/2021 05:11:05,624744,661485,36741,809
6115,14/06/2021 18:58:27,14/06/2021 18:58:31,14/06/2021 22:10:01,15/06/2021 06:39:55,606131,617759,11628,701
6155,14/06/2021 17:58:24,14/06/2021 17:58:25,15/06/2021 08:18:44,15/06/2021 08:18:51,211679,222078,10399,860
6151,15/06/2021 10:24:23,,,,,,,
6170,15/06/2021 10:07:53,15/06/2021 10:07:54,15/06/2021 11:20:20,15/06/2021 11:20:22,661495,665865,4370,72
